1er	01
a-t-il	vouloir
adresses	auteur
affiche 	vouloir
afp	afp
aimerais	vouloir
année	date
articlent	article
articles 	article
articules 	article
auteurs	auteur
comment	vouloir
concernant	parler
concernent	parler
contacter	email
contenant	parler
contenus	parler
contient 	parler
dates	date
domaine	email
donne 	vouloir
donne-moi	vouloir
donnez	vouloir
donnez-moi	vouloir
e-mail	email
évoque	parler
liés	parler
mail	email
nombre	combien
on	parler
ont	parler
pages	page
par	auteur
parle 	parler
parle-t-on	parler
parlé	parler
parlant	parler
parlent 	parler
parlent-t-on	parler
partir	premier
portant	parler
porte	parler
possédant	parler
pqges	page
publié	publie
quand	date
quel	vouloir
quelle	vouloir
quelles	vouloir
quels	vouloir
rappels	rappels
rapport	theme
réference	parler
référence	parler
résumés	resume
retourner	vouloir
rubriques 	rubrique
souhaiterais	vouloir
thème	theme
thèmes	theme
théme	theme
titres 	titre
traitant	parler
traitants	parler
traite 	parler
traité	parler
traitent 	parler
unes	une
veux 	vouloir
voudrais 	vouloir
y-a-t-il	vouloir
email	email
mail	email
contenir	contenir
vouloir	vouloir
theme	theme
et	et
ou	ou
combien combien