« 	« 
ça 	ça 
ça 	ça 
ça 	ça 
ça 	ça 
ça 	ça 
a 	a 
a 	a 
a 	a 
a 	a 
a 	a 
a 	a 
a320 	a320 
a340 	a340 
abandon 	abandon
abandonne 	abandon
abandonner 	abandon
abandonnés 	abandon
abat 	abat 
abattent 	abattent 
abattre 	abattre 
abattu 	abattu 
abattue 	abattue 
abattues 	abattues 
abattu mercredi 	abattu mercredi 
abattus 	abattus 
abbas 	abbas 
abdallah 	abdallah 
abdel 	abdel 
abdoul 	abdoul 
abidjan 	abidjan 
abîmé 	abîmé 
abonnement 	abonnement 
abord 	abord 
abordé 	abordé 
aborde 	aborde 
aborder 	aborder 
abords 	abords 
abortive 	abortive 
abou 	abou 
abouti 	abouti
aboutir 	abouti
abqaiq 	abqaiq 
abraham 	abraham 
abramoff 	abramoff 
abri 	abri 
abris 	abris 
absence 	absence 
absolue 	absolu
absolument 	absolu
absorption 	absorption 
abstention 	abstention 
abuja 	abuja 
abus 	abus 
abus 	abus 
abusé 	abusé 
abusé 	abusé 
abuser 	abuser 
académie 	académie 
accablant 	accablant
accablants 	accablant
accable 	accabl
accablent 	accabl
accalmie 	accalmie 
accède 	accède 
accédera 	accédera 
accentuer 	accentuer 
accepté 	accept
acceptables 	accept
acceptée 	accept
accepte 	accept
accepter 	accept
acceptera 	accept
acceptés 	accept
accession 	accession 
accident 	accident
accident 	accident
accidenté 	accident
accidentelle 	accident
accidentellement 	accident
accidents 	accident
accélération 	accél
accélèrent 	accél
accompagné 	accompagn
accompagnaient 	accompagn
accompagnateurs 	accompagn
accompagnée 	accompagn
accompagnent 	accompagn
accompagner 	accompagn
accompli 	accomp
accord 	accord
accord 	accord
accord 	accord
accord 	accord
accordé 	accord
accordé 	accord
accordé 	accord
accordée 	accord
accorde 	accord
accordent 	accord
accorder 	accord
accorderaient 	accord
accords 	accord
accouru 	accouru 
accrochage 	accrochage
accrochages 	accrochage
accroche 	accroch
accroît 	accroît 
accrus 	accrus 
accès 	accès 
accueil 	accueil
accueillent 	accueil
accueilli 	accueil
accueillie 	accueil
acculé 	acculé 
accusé 	accusé 
accusateur 	accusat
accusation 	accusation
accusations 	accusation
accusée 	accusée 
accusée 	accusée 
accusée 	accusée 
accuse 	accuse 
accuse 	accuse 
accusent 	accusent 
accusées 	accusées 
accusés 	accusés 
aceh 	aceh 
acharnait 	acharn
acharner 	acharn
achat 	achat 
acheminement 	achemine
acheminer 	achemine
acheteurs 	acheteurs 
achevé 	achevé 
achevait 	achevait 
achever 	achever 
achoppaient 	achoppaient 
achève 	achève 
acquisition 	acqu
acquitté 	acquitt
acquittant 	acquitt
acquittement 	acquitt
acquérir 	acqu
acte 	acte 
actes 	actes 
acteur 	acteur
acteurs 	acteur
action 	action
actionner 	action
actions 	action
active 	active 
activement 	activement 
activiste 	activiste
activistes 	activiste
activité 	activité
activités 	activité
actualisé 	actualisé 
actuel 	actuel
actuelle 	actuelle
actuellement 	actuelle
actuelles 	actuelle
adam 	adam 
adel 	adel 
adhésion 	adhésion 
adieu 	adieu 
adjoint 	adjoint 
admet 	admet 
administrateur 	administrat
administration 	administrat
administrée 	administr
administrés 	administr
admiration 	admiration 
adolescent 	adolescent
adolescents 	adolescent
adopté 	adopt
adoptée 	adopt
adopter 	adopt
adoption 	adopt
ados 	ados 
adressé 	adress
adressant 	adress
adresse 	adress
adversaire 	adversaire
adversaires 	adversaire
aeia 	aeia 
afar 	afar 
affaibli 	affaibli
affaiblie 	affaibli
affaiblissement 	affaibli
affaire 	affaire
affaires 	affaire
affecté 	affect
affectées 	affect
affectionne 	affect
affectueux 	affect
affiché 	affich
affichaient 	affich
affiche 	affich
affiches 	affich
affirmé 	affirm
affirmait 	affirm
affirmant 	affirm
affirmations 	affirm
affirme 	affirm
affirment 	affirm
affirmer 	affirm
afflue 	afflu
affluence 	afflu
affluent 	afflu
affluents 	afflu
afflux 	afflu
affreusement 	affreusement 
affronté 	affront
affrontement 	affrontement
affrontements 	affrontement
affrontent 	affront
affronter 	affront
affrontera 	affront
affréteur 	affréteur 
afghan 	afghan
afghane 	afghan
afghanistan 	afghan
afghans 	afghan
afin 	afin 
afp 	afp 
africain 	africain
africaine 	africain
africaines 	africain
africains 	africain
afrique 	afri
agé 	agé 
agacé 	agac
agace 	agac
agacent 	agac
agca 	agca 
agée 	agée 
agence 	agen
agent 	agen
agents 	agen
agglomération 	agglomération 
aggravé 	aggrav
aggrave 	aggrav
aggraver 	aggrav
agi 	agi 
agir 	agir 
agirait 	agirait 
agissait 	agiss
agissant 	agiss
agisse 	agiss
agissements 	agiss
agit 	agit 
agit 	agit 
agité 	agité 
agite 	agite 
agitent 	agitent 
agnostique 	agnostique 
agonie 	agonie 
agrandissement 	agrandi
agrandit 	agrandi
agresser 	agress
agression 	agression
agressions 	agression
agricole 	agricole
agricoles 	agricole
agriculture 	agric
agés 	agés 
aguirre 	aguirre 
ahmadenijad 	ahmad
ahmadinejad 	ahmadinejad
ahmadinejad était 	ahmadinejad
ahmet 	ahmet 
ai 	ai 
aibrus 	aibrus 
aidé 	aidé 
aide 	aide 
aider 	aider 
aides 	aides 
aidez 	aidez 
aidés 	aidés 
aiea 	aiea 
aient 	aient 
aigle 	aigle 
aigu 	aigu 
aile 	aile 
ailleurs 	ailleurs 
aime 	aime
aiment 	aime
ainsi 	ainsi 
air 	air 
airbus 	airbus 
airlines 	airlines 
airways 	airways 
ait 	ait 
ajourné 	ajourné
ajournés 	ajourné
ajouté 	ajou
ajoutent 	ajou
akbar 	akbar 
akihiko 	akihiko 
akrotiri 	akrotiri 
al 	al 
alabama 	alabama 
alain 	alain 
alarmante 	alarmante 
alaska 	alaska 
albanais 	albanais 
albert 	albert 
alcool 	alcool
alcoolisme 	alcool
alerte 	alerte
alertes 	alerte
alfredo 	alfredo 
alger 	alger 
algérie 	algérie
algérien 	algérie
algérienne 	algérie
algériens 	algérie
ali 	ali 
aliev 	aliev 
alignés 	alignés 
alimentaire 	aliment
alimentant 	aliment
alimentation 	aliment
alimenter 	aliment
alito 	alito 
allé 	allé 
allaient 	alla
allait 	alla
allant 	alla
allaoui 	alla
allemagne 	alle
allemand 	alle
allemande 	alle
allemandes 	alle
allemands 	alle
allen 	alle
aller 	alle
allez 	alle
allégations 	allégations 
allié 	alli
alliance 	alli
allie 	alli
alliés 	alli
allocution 	allo
allons 	allo
almere 	almere 
alors 	alors 
alourdir 	alourdi
alourdit 	alourdi
alpha 	alpha 
alpin 	alpin
alpiniste 	alpiniste
alpinistes 	alpiniste
altermondialistes 	alter
alternative 	alter
altitude 	altitude 
alvaro 	alvaro 
am 	am 
amal 	amal 
amalgame 	amalgame 
amarré 	amarré 
amassée 	amassée 
amateurs 	amateurs 
amazonienne 	amazonienne 
ambassade 	ambassade
ambassades 	ambassade
ambassadeur 	ambassade
ambassadeurs 	ambassade
ambiance 	ambiance 
ambitionne 	ambitionne 
amenait 	amenait 
amende 	amende
amendes 	amende
amenuiser 	amenuiser 
american 	american 
amerri 	amerri
amerrissage 	amerri
ami 	ami 
amical 	amical 
amine 	amine 
amitié 	amitié 
amélie 	améli
améliore 	améli
amman 	amman 
amène 	amène 
amnesty 	amnesty 
amnésique 	amnésique 
amour 	amour 
amphibies 	amphibies 
ampleur 	ampleur 
amplifier 	amplifier 
ampoules 	ampoules 
américain 	américain
américaine 	américain
américaines 	américain
américains 	américain
américano 	améri
amérindien 	améri
amérique 	améri
amériques 	améri
amsterdam 	amsterdam
amsterdam 	amsterdam
amsterdam  	amsterdam
amusé 	amus
amuser 	amus
aîné 	aîné 
an 	an 
analyse 	analyse
analyser 	analyse
analyses 	analyse
anapurna 	anapurna 
anarchie 	anarchi
anarchistes 	anarchi
ancien 	ancien
ancienne 	ancien
anciens 	ancien
anciens otages 	ancien
andhra 	andhra 
andijan 	andijan 
andré 	andré 
andreas 	andreas 
ange 	ange 
angela 	angela 
angeles 	angeles 
angelo 	angelo 
anges 	anges 
angie 	angie 
anglais 	anglais
anglaise 	anglais
angleterre 	angleterre 
anglo 	anglo 
angélus 	angélus 
angoisse 	angoisse 
animé 	anim
animaux 	anim
animée 	anim
animer 	anim
ankara 	ankara 
annan 	annan 
annapurna 	annapurna 
année 	année 
année 	année 
anne 	anne 
années 	années 
anniversaire 	anniversaire 
annoné 	annon
annonçant 	annon
annoncé 	annon
annoncée 	annon
annoncée 	annon
annoncée 	annon
annoncée 	annon
annoncée 	annon
annoncée 	annon
annoncée 	annon
annoncée 	annon
annonce 	annon
annonce 	annon
annonce 	annon
annonce 	annon
annonce 	annon
annonce 	annon
annonce 	annon
annonce 	annon
annonce 	annon
annoncent 	annon
annoncer 	annon
annoncées 	annon
annoncés 	annon
annuel 	annuel 
annulé 	annulé 
annulée 	annulée 
annulée 	annulée 
annule 	annule 
anomalie 	anomalie
anomalies 	anomalie
anonymes 	anonymes 
anormal 	anormal 
ans 	ans 
ante 	ante 
anti 	anti 
anticipées 	anticipées 
anticonstitutionnelle 	anticonstitutionnelle 
antijaponaises 	antijaponaises 
antillais 	antill
antilles 	antill
antinucléaire 	antinucléaire 
antisémitisme 	antisémitisme 
antisyrien 	antisyrien 
antiterrorisme 	antiterroris
antiterroriste 	antiterroris
antonio 	antonio 
antépénultième 	antépénultième 
antérieurs 	antérieurs 
anxiété 	anxiété 
août 	août 
aoun 	aoun 
ap 	ap 
apaiser 	apaiser 
apitoiement 	apitoiement 
apostolique 	apostolique 
apparaît 	appar
apparaître 	appar
appareil 	appar
appareils 	appar
apparemment 	appar
apparition 	appar
appartement 	appar
appartements 	appar
appartenance 	appar
appartenant 	appar
appartenir 	appar
apparu 	appar
appel 	appel
appel 	appel
appel 	appel
appel 	appel
appel 	appel
appel 	appel
appel 	appel
appel 	appel
appel 	appel
appel 	appel
appel 	appel
appel 	appel
appel 	appel
appel 	appel
appel 	appel
appel 	appel
appel 	appel
appel 	appel
appel 	appel
appel 	appel
appel 	appel
appel 	appel
appelé 	appel
appelé 	appel
appelé 	appel
appelé 	appel
appelé 	appel
appelé 	appel
appelé 	appel
appelé 	appel
appelé 	appel
appelé 	appel
appelé 	appel
appelé 	appel
appelé 	appel
appelé 	appel
appelé 	appel
appelé 	appel
appelé 	appel
appelé 	appel
appelé 	appel
appelé 	appel
appelé 	appel
appelé 	appel
appelant 	appel
appelée 	appel
appeler 	appel
appelle 	appel
appellent 	appel
appelés 	appel
appelés 	appel
appelés 	appel
appelés 	appel
appels 	appel
appels 	appel
appels 	appel
appels 	appel
applaudissements 	applaudissements 
apple 	apple 
application 	application 
appliquer 	appliquer 
apporté 	apport
apporte 	apport
apportent 	apport
apportées 	apport
apprécie 	apprécie 
apprend 	apprend
apprendre 	apprend
appréhendées 	appréhendées 
approbation 	approbation 
approchait 	approch
approche 	approch
approches 	approch
approuvé 	approuv
approuvée 	approuv
approuve 	approuv
approuver 	approuv
approuvés  	approuv
approvisionnement 	approvisionnement
approvisionnements 	approvisionnement
apprêtaient 	apprêt
apprête 	apprêt
apprêtent 	apprêt
appui 	appui 
appuie 	appuie 
appuyer 	appuyer 
apôtre 	apôtre 
aqaba 	aqaba 
aqsa 	aqsa 
arabe 	arabe 
arabes 	arabes 
arabie 	arabie 
arabiya 	arabiya 
arafat 	arafat 
aragoncillo 	aragoncillo 
arbres 	arbres 
arc 	arc 
archevêque 	archevêque 
archipel 	archipel 
archéologique 	archéolog
archéologue 	archéolog
archétype 	archétype 
arctique 	arctique 
ardente 	ardente 
ardoise 	ardoise 
argent 	argent
argentin 	argentin
argentine 	argentin
argument 	argument
arguments 	argument
ariel 	ariel 
aérien 	aérien
aérienne 	aérien
aériennes 	aérien
aériens 	aérien
arik 	arik 
arizona 	arizona 
armé 	armé 
armée 	armée 
armée 	armée 
armée 	armée 
armée 	armée 
armée 	armée 
armée 	armée 
armée 	armée 
armée 	armée 
armée 	armée 
armée 	armée 
armée 	armée 
armée 	armée 
armée 	armée 
armée 	armée 
arme 	arme 
arme 	arme 
arme 	arme 
arme 	arme 
arme 	arme 
arme 	arme 
arme 	arme 
arme 	arme 
arme 	arme 
arme 	arme 
arme 	arme 
arme 	arme 
arme 	arme 
armées 	armées 
armées 	armées 
armées 	armées 
armées 	armées 
armées 	armées 
armes 	armes 
armes 	armes 
armes 	armes 
armes 	armes 
armes 	armes 
armes 	armes 
armin 	armin 
arménie 	arménie 
armés 	armés 
army 	army 
arnaud 	arnaud 
arnold 	arnold 
aérogare 	aéro
aéroport 	aéroport
aéroports 	aéroport
aéroportuaires 	aéroport
arraché 	arrach
arrachent 	arrach
arrachés 	arrach
arrestation 	arrestation
arrestations 	arrestation
arrière 	arrière 
arrivé 	arrivé 
arrivaient 	arrivaient 
arrivée 	arrivée 
arrivée 	arrivée 
arrivée 	arrivée 
arrive 	arrive 
arrive 	arrive 
arrivent 	arrivent 
arriver 	arriver
arrivera 	arriver
arrivées 	arrivées 
arrivés 	arrivés 
arrogants 	arrogants 
arroyo 	arroyo 
arrêt 	arrêt
arrêt 	arrêt
arrêt 	arrêt
arrêt 	arrêt
arrêt 	arrêt
arrêt 	arrêt
arrêt 	arrêt
arrêté 	arrêt
arrêté 	arrêt
arrêté 	arrêt
arrêté 	arrêt
arrêté 	arrêt
arrêté 	arrêt
arrêté 	arrêt
arrêté 	arrêt
arrêtant 	arrêt
arrêtée 	arrêt
arrêter 	arrêt
arrêtées 	arrêt
arrêtés 	arrêt
arsenal 	arsenal 
arthur 	arthur 
article 	article
articles 	article
artifice 	artific
artifices 	artific
artificiel 	artificie
artificielle 	artificie
artificier 	artificie
artillerie 	artillerie 
artisanal 	artisanal
artisanale 	artisanal
artistique 	artistique 
artémis 	artémis 
aruba 	aruba 
ascendant 	ascen
ascensio 	ascensio
ascension 	ascensio
ashland 	ashland 
asiatique 	asiatique
asiatiques 	asiatique
asie 	asie 
asile 	asile 
asphalte 	asph
asphyxie 	asph
assad 	assad 
assaillants 	assaill
assaillie 	assaill
assaillis 	assaill
assassin 	assassin
assassiné 	assassin
assassiné 	assassin
assassinat 	assassin
assassinats 	assassin
assassiner 	assassin
assaut 	assaut
assauts 	assaut
assèchement 	assèchement 
assemblée 	assemblée 
assez 	assez 
assiégées 	assiégées 
assimilation 	assimilation 
assise 	assise 
assisté 	assisté 
assistance 	assistance 
assistée 	assistée 
assistent 	assistent 
assister 	assister 
assène 	assène 
associé 	associ
association 	associ
associations 	associ
associe 	associ
assombries 	assombries 
assommé 	assommé
assommée 	assommé
assumé 	assumé 
assume 	assume 
assumerait 	assumerait 
assuré 	assuré 
assurait 	assurait 
assurances 	assurances 
assurant 	assurant 
assurée 	assurée 
assurée 	assurée 
assure 	assure 
assure 	assure 
assure 	assure 
assurent 	assurent 
assurer 	assurer 
assurées 	assurées 
assurés 	assurés 
astronomique 	astronomique 
aswat 	aswat 
athée 	athée 
athlètes 	athlètes 
athènes 	athènes 
atlanta 	atlant
atlantique 	atlant
atmosphère 	atmosphère 
atomique 	atomique 
atr 	atr 
atrocités 	atrocités 
atsmona 	atsmona 
attache 	attache 
attaquée 	attaqu
attaque 	attaqu
attaque 	attaqu
attaquer 	attaqu
attaques 	attaqu
atteignant 	atteignant 
atteindre 	atteindre 
atteint 	atteint 
atteinte 	atteinte 
attelage 	attelage 
attend 	attend 
attendait 	attendait 
attendant 	attendant 
attendent 	attendent 
attendra 	attendra 
attendre 	attendre 
attendu 	attendu 
attendue 	attendue 
attendues 	attendues 
attendus 	attendus 
attentat 	attentat
attentats 	attentat
attente 	attente 
attentes 	attentes 
attention 	attention 
attentisme 	attentisme 
attentivement 	attentivement 
atterrir 	atterri
atterrissage 	atterri
atteste 	atteste 
attiré 	attiré 
attirant 	attirant 
attirer 	attirer 
attisé 	attisé 
attiser 	attiser 
attisées 	attisées 
attitude 	attitude 
attorney 	attorney 
attractif 	attractif 
attribué 	attribu
attribue 	attribu
attribution 	attribu
atypique 	atypique 
aube 	aube
aubenas 	aube
aucun 	aucun
aucune 	aucun
audacieux 	audacieux 
aude 	aude 
audience 	audience
audiences 	audience
audio 	audio 
audition 	audition
auditionnées 	audition
au détriment 	au détriment 
augmentation 	augment
augmentent 	augment
aujourd 	aujourd 
auparavant 	auparavant 
auprès 	auprès 
auquel 	auquel 
aura 	aura 
auraient 	auraient 
aurait 	aurait 
auriez 	auriez 
auront 	auront 
auschwitz 	auschwitz 
aussi 	aussi
aussitôt 	aussi
australie 	australie
australienne 	australie
autant 	autant 
auteur 	auteur
auteurs 	auteur
authenticité 	authenti
authentifié 	authenti
authentifiés 	authenti
authentiques 	authenti
auto 	auto 
autoaccusation 	autoaccusation 
autobus 	autobus 
autocar 	autocar 
automne 	automne 
automobilistes 	automobilistes 
autopsie 	autopsie 
autorisé 	autori
autorisant 	autori
autorisée 	autori
autorisée 	autori
autorise 	autori
autorisent 	autori
autoriser 	autori
autorisées 	autori
autorisés 	autori
autorité 	autori
autoritaires 	autori
autorités 	autori
autour 	autour 
autre 	autre 
autres 	autres 
autriche 	autrich
autrichien 	autrichien
autrichiennes 	autrichien
autrichiens 	autrichien
auxquels 	auxquels 
aux urnes 	aux urnes 
avaient 	avaient 
avais 	avais 
avait 	avait 
aval 	aval 
avaler 	avaler 
avancée 	avancée 
avance 	avance 
avance 	avance 
avancées 	avancées 
avant 	avant 
avantage 	avantage 
avenir 	avenir 
aventure 	aventure 
avertir 	averti
avertissement 	avertissement
avertissements 	avertissement
aveu 	aveu 
aveugle 	aveugle 
avez 	avez 
aviation 	aviation 
avion 	avion
avions 	avion
avis 	avis 
aviv 	aviv 
avènement 	avènement 
avocat 	avocat
avocate 	avocat
avocats 	avocat
avoir 	avoir 
avons 	avons 
avortement 	avortement 
avoué 	avoué 
avoue 	avoue 
avérée 	avér
avérer 	avér
avril 	avril 
axée 	axée 
axes 	axes 
ayant 	ayant 
ayman 	ayman
aymane 	ayman
ayons 	ayons 
azadliq 	azadliq 
azerbaïdjan 	azerbaïdjan
azerbaïdjanaise 	azerbaïdjan
azimuts 	azimuts 
aziz 	aziz 
azouz 	azouz 
azrou 	azrou 
baaqouba 	baaqouba 
baas 	baas 
baasiste 	baasiste 
bachar 	bachar 
bachelet 	bachelet 
bachir 	bachir 
bactéries 	bactéries 
bad 	bad 
bagage 	bagage 
bagarres 	bagarres 
bagdad 	bagdad 
bahamas 	bahamas 
baie 	baie 
baigne 	baigne 
bain 	bain 
baisse 	baisse
baisser 	baisse
baisses 	baisse
bakar 	bakar 
bakiev 	bakiev 
bakou 	bakou 
bakri 	bakri 
balad 	balad 
balakot 	balakot 
balayé 	balayé
balayée 	balayé
balcon 	balcon 
bali 	bali 
balkarie 	balkarie 
balland 	balland 
balle 	balle 
balles 	balles 
balnéaire 	balnéaire 
bamako 	bamako 
banale 	banale 
bancaires 	bancaires 
banda 	banda 
bande 	bande 
bandes 	bandes 
bandit 	bandit
bandits 	bandit
bandés 	bandés 
bangkok 	bangkok 
bangladesh 	bangladesh 
bangor 	bangor 
bank 	bank 
banlieue 	banlieue
banlieues 	banlieue
banni 	banni
bannir 	banni
bannis 	banni
banque 	banque 
baptisé 	baptis
baptisée 	baptis
baptistes 	baptis
barah 	barah 
barbare 	barbare
barbares 	barbare
barbe 	barbe 
barbecue 	barbecue 
barcelone 	barcelone 
bari 	bari 
baron 	baron 
baroud 	baroud 
barrage 	barrage 
barre 	barre 
barrer 	barrer 
barricades 	barricades 
barrie 	barrie 
barroso 	barroso 
bars 	bars 
bas 	bas 
bas 	bas 
basé 	basé 
basé 	basé 
basculé 	basculé 
base 	base 
baser 	baser 
basées 	basées 
bases 	bases 
basescu 	basescu 
basilique 	basilique 
basque 	basque
basques 	basque
basse 	basse 
bassorah 	bassorah 
bastions 	bastions 
bat 	bat 
bataille 	bataille
batailles 	bataille
bateaux 	bateaux 
bathyscaphe 	bathyscaphe 
béatifié 	béatifi
béatification 	béatifi
ébats 	ébats 
battante 	battante 
battre 	battre 
battu 	battu 
baturin 	baturin 
bavarois 	bavarois 
bavière 	bavière 
bavure 	bavure 
bébé 	bébé 
bbc 	bbc 
béchir 	béchir 
bâclée 	bâclée 
bea 	bea 
beatle 	beatle 
beau 	beau 
beaucoup 	beaucoup 
beaumont 	beaumont 
beersheva 	beersheva 
begag 	begag 
bel 	bel 
belge 	belge 
belges 	belges 
belgique 	belgique 
belgrade 	belgrade 
belles 	belles 
ben 	ben 
bendit 	bendit 
benghazi 	benghazi 
benito 	benito 
benjamin 	benjamin 
benoûit 	benoûit 
benoit 	benoit 
benoît 	benoît 
berlin 	berlin 
berlusconi 	berlusconi 
berné 	berné 
bernard 	bernard 
berrebi 	berrebi 
beslan 	beslan 
besoin 	besoin 
best 	best 
betancourt 	betancourt 
bethléem 	bethléem 
beuveries 	beuveries 
beyrouth 	beyrouth 
biathlon 	biathlon 
bichkek 	bichkek 
bien 	bien
biens 	bien
bientôt 	bien
bienveillance 	bien
big 	big 
bilan 	bilan
bilans 	bilan
bild 	bild 
bilici 	bilici 
bill 	bill 
billet 	billet
billets 	billet
binge 	binge 
biographie 	biographie 
biométrique 	biométrique
biométriques 	biométrique
bioéthique 	bioéthique 
birmane 	birm
birmingham 	birm
bis 	bis 
blair 	blair 
blanc 	blanc
blanche 	blanc
blanches 	blanc
blanchi 	blanc
blancs 	blanc
blason 	blason 
blasy 	blasy 
blazy 	blazy 
bâle 	bâle 
blessé 	bless
blessée 	bless
blesser 	bless
blessées 	bless
blessés 	bless
bleus 	bleus 
bloc 	bloc 
blocage 	blocage 
blocus 	blocus 
bloomberg 	bloomberg 
bloqué 	bloqu
bloquaient 	bloqu
bloquant 	bloqu
bloquée 	bloqu
bloque 	bloqu
bloquent 	bloqu
bloquer 	bloqu
bloquées 	bloqu
bloqués 	bloqu
bénédiction 	bénédiction 
bénéficie 	bénéficie
bénéficient 	bénéficie
béni 	béni 
bénit 	bénit 
bnn 	bnn 
boeing 	boeing 
boire 	boire 
boisson 	boisson 
bolivars 	boliv
bolivie 	bolivie
bolivien 	bolivie
boliviens 	bolivie
bolkestein 	bolkestein 
bolton 	bolton 
bombardé 	bombard
bombardement 	bombardement
bombardements 	bombardement
bombarder 	bombard
bombardées 	bombard
bombay 	bomb
bombe 	bomb
bombes 	bomb
bon 	bon 
bondé 	bondé 
bondsteel 	bondsteel 
bongo 	bongo 
bonne 	bonne
bonnes 	bonne
bono 	bono 
bons 	bons 
bord 	bord 
bosnie 	bosnie 
boston 	boston 
boîte 	boîte
boîtes 	boîte
bouche 	bouche 
bouchons 	bouchons 
bouclé 	bouclé 
bouclage 	bouclage 
bouclée 	bouclée 
boucle 	boucle 
bouclier 	bouclier 
boude 	boude
boudent 	boude
boue 	boue 
bouffée 	bouffée 
bourgs 	bourgs 
bourreau 	bourreau 
bourse 	bourse 
bousculade 	bouscula
bousculaient 	bouscula
bout 	bout 
bouteflika 	bouteflika 
bouyeri 	bouyeri 
bowles 	bowles 
boycotte 	boycotte
boycotter 	boycotte
boyd 	boyd 
bp 	bp 
branche 	bran
brandies 	brandi
brandit 	brandi
ébranlée 	ébranl
ébranle 	ébranl
braquage 	braquage 
bras 	bras 
bratislava 	bratislava 
bravant 	bravant 
brèches 	brèches 
brefs 	brefs 
bretagne 	bretagne 
brevet 	brevet 
bricolage 	bricolage 
bridge 	bridge 
brigades 	brigades 
briguera 	briguera
briguerait 	briguera
brio 	brio 
britannique 	britannique
britanniques 	britannique
brièvement 	brièvement 
brûlé 	brûl
brûler 	brûl
broncho 	broncho 
bronzés 	bronzés 
brookfield 	brookfield 
brother 	brother 
broussailles 	broussailles 
brown 	brown 
brésil 	brésil
brésilen 	brésil
brésilien 	brésil
brésiliens 	brésil
bruley 	bruley 
brusque 	brusque 
brut 	brut 
brutalisé 	brutalisé 
bruxelles 	bruxelles 
brève 	brève 
bétail 	bétail 
bêtes 	bêtes 
bâtiment 	bâtiment
bâtiments 	bâtiment
béton 	béton 
bu 	bu 
bucarest 	bucarest 
buchenwald 	buchenwald 
budget 	budget
budgets 	budget
bulgares 	bulgar
bulgarie 	bulgar
bulletin 	bulletin
bulletins 	bulletin
buncefield 	buncefield 
bunker 	bunker 
bureau 	bureau
bureaux 	bureau
burundaise 	burundaise 
bus 	bus 
bush 	bush 
but 	but 
butin 	butin 
c 	c 
c130 	c130 
ca 	ca 
cabine 	cabine
cabinet 	cabine
cachaient 	cach
cachemire 	cach
cachées 	cach
cachés 	cach
cadavres 	cadavres 
cadena 	cadena 
cadre 	cadre 
cagnotte 	cagnotte 
caillaissée 	caillaissée 
caire 	caire 
caisses 	caisses 
calciné 	calciné 
calderoli 	calderoli 
calendrier 	calendrier 
californie 	californie
californienne 	californie
calipari 	calipari 
callaghan 	callaghan 
calme 	calme
calmer 	calme
calqué 	calqué 
calvaire 	calvaire 
cambodgienne 	cambodgienne 
cambriolage 	cambriol
cambrioleurs 	cambriol
camerlingue 	camer
cameron 	camer
cameroun 	camer
camilla 	camill
camille 	camill
camion 	camion
camionnette 	camion
camorra 	camorra 
camouflet 	camouflet 
camp 	camp 
camp 	camp 
campé 	campé 
campagne 	campagne 
campent 	campent 
camps 	camps 
caméras 	caméras 
canada 	canada 
canadien 	canadien
canadienne 	canadien
canadiennes 	canadien
canadiens 	canadien
canal 	canal 
canard 	canard 
canaries 	canaries 
cancer 	cancer 
cancun 	cancun 
candidat 	candidat
candidate 	candidat
candidates 	candidat
candidats 	candidat
candidature 	candidat
candidatures 	candidat
cannibale 	cannibale 
canon 	canon
canonisation 	canon
cantal 	cantal 
canton 	canton
cantoni 	canton
cantonné 	canton
cantons 	canton
canular 	canular 
caoutchouc 	caoutchouc 
cap 	cap 
capable 	capable
capables 	capable
capacité 	capacité 
capitale 	capitale
capitales 	capitale
capitulation 	capit
capoter 	capoter 
caprices 	caprices 
captivité 	captivité 
capturé 	captur
capture 	captur
capturés 	captur
car 	car 
caraïbes 	caraïbes 
carabiniers 	carabiniers 
caracas 	caracas 
caractère 	caractère 
carbone 	carbone 
carburant 	carburant 
cardiaque 	cardi
cardiaques 	cardi
cardinal 	cardi
cardinaux 	cardi
cardio 	cardi
care 	care 
cargo 	cargo 
caribbean 	caribbean 
caricatures 	caricatur
caricaturiste 	caricatur
carla 	carla 
carles 	carles 
carlingue 	carlingue 
carlos 	carlos 
carnage 	carna
carnaval 	carna
caroline 	caroline 
carrière 	carrière 
carroll 	carroll 
écarté 	écarté 
écarte 	écarte 
carte 	carte 
carte 	carte 
écarter 	écarter 
cartes 	cartes 
carton 	carton
cartons 	carton
écartés 	écartés 
cas 	cas 
casques 	casques 
cassation 	cassation 
casse 	casse 
cassez 	cassez 
castro 	castro 
catalogne 	catalogne 
catastrophe 	catastroph
catastrophes 	catastroph
catastrophique 	catastrophique
catastrophiques 	catastrophique
catégorie 	catégorie 
cathédrale 	cathédrale 
catholicisme 	catholi
catholique 	catholique
catholiques 	catholique
cathéter 	cathét
cathéther 	cathét
caucase 	caucase 
cauchemar 	cauchemar 
causé 	causé 
causée 	causée 
cause 	cause 
cause 	cause 
causes 	causes 
caution 	caution
cautionné 	caution
cavaco 	cavaco 
cavale 	cavale 
cave 	cave 
câbles 	câbles 
cédé 	cédé 
cédant 	cédant 
cède 	cède 
céder 	céder 
cèdre 	cèdre 
cdu 	cdu 
ceaucescu 	ceau
ceausescu 	ceau
ceinture 	ceinture 
cela 	cela 
celebrity 	celebrity 
celle 	celle 
celles 	celles 
cellule 	cellule
cellules 	cellule
celui 	celui 
censée 	censée 
censure 	censure 
cent 	cent 
centaine 	centaine
centaines 	centaine
center 	center 
central 	central
centrale 	central
centre 	centre 
centres 	centres 
centriste 	centriste
centristes 	centriste
cents 	cents 
cependant 	cependant 
cerné 	cerné 
cerne 	cerne 
certaine 	certain
certaines 	certain
certains 	certain
certifié 	certifié 
cerveau 	cerveau 
ces 	ces 
cesme 	cesme 
cessé 	cessé 
cessaient 	cessaient 
cesse 	cesse 
cessent 	cessent 
cesser 	cesser 
cessez 	cessez 
cet 	cet 
cette 	cette 
ceuta 	ceuta 
ceux 	ceux 
chacun 	chacun 
chaleur 	chaleur
chaleureux 	chaleur
chambre 	chambre 
champ 	champ 
champion 	champion 
chamy 	chamy 
chance 	chance
chancelier 	chance
chancelière 	chance
chancellerie 	chance
chances 	chance
chaîne 	chaîne
chaînes 	chaîne
changé 	changé 
échange 	échange 
changement 	change
changent 	change
échanger 	échanger 
échanges 	échanges 
échangés 	échangés 
chantage 	chant
chanteur 	chanteu
chanteuse 	chanteu
chaos 	chaos 
chaotique 	chaotique 
chapelle 	chapelle 
chapitre 	chapitre 
chapman 	chapman 
échappé 	échapp
échappait 	échapp
échappe 	échapp
chaque 	chaque 
charbon 	charbon 
chargé 	chargé 
chargée 	chargée 
chargée 	chargée 
charge 	charge 
charge 	charge 
charge 	charge 
chargerait 	chargerait 
chargées 	chargées 
chargés 	chargés 
charismatique 	charismatique 
charité 	charité 
charles 	charles 
charleville 	charleville 
charlotte 	charlotte 
charm 	charm 
charte 	charte
charter 	charte
charters 	charte
charvolin 	charvolin 
chasse 	chass
chasseur 	chasseur
chasseurs 	chasseur
chassés 	chass
chat 	chat 
chauds 	chauds 
chauffard 	chauff
chauffeur 	chauff
échauffourées 	échauffourées 
chavez 	chavez 
chebaa 	chebaa 
échec 	échec 
chef 	chef
chefs 	chef
cheick 	chei
cheikh 	chei
échelle 	échelle 
chemin 	chemin
cheminée 	chemin
chemins 	chemin
cheney 	cheney 
cherchait 	cherch
cherchant 	cherch
cherche 	cherch
cherchent 	cherch
chercherait 	cherch
chercheur 	cherch
cherie 	cher
chesnot 	chesnot 
écheveau 	écheveau 
chevet 	chevet 
chez 	chez 
chiapas 	chiapas 
chicago 	chica
chicano 	chica
chiffre 	chiffre
chiffres 	chiffre
chiite 	chiite
chiites 	chiite
children 	children 
chili 	chili 
chilienne 	chilien
chiliens 	chilien
chimique 	chimique
chimiques 	chimique
chimiste 	chimi
chine 	chine 
chinois 	chinois
chinoises 	chinois
chirac 	chirac 
chirurgical 	chirurgical 
chitte 	chitte 
écho 	écho 
choc 	choc 
choeur 	choeur 
choisi 	choisi
choisir 	choisi
choisiront 	choisi
choisis 	choisi
choisissait 	choisi
choisissent 	choisi
choisissez 	choisi
choisit 	choisi
choix 	choix 
choléra 	choléra 
choqué 	choqu
choquante 	choqu
choque 	choqu
choqués 	choqu
chorzow 	chorzow 
chose 	chose 
échoué 	échoué 
échouer 	échouer 
chouet 	chouet 
chèque 	chèque 
chris 	chris
christ 	chris
christian 	christian
christianisme 	christian
christophe 	chris
chronique 	chron
chronologie 	chron
chrétien 	chrétien
chrétienne 	chrétien
chrétiennes 	chrétien
chrétiens 	chrétien
château 	château 
chute 	chute
chuter 	chute
chutes 	chute
chypre 	chypr
chypriote 	chypr
ci 	ci 
cia 	cia 
ciblée 	cibl
cible 	cibl
cible 	cibl
ciblées 	cibl
ciblées 	cibl
cibles 	cibl
cibles 	cibl
cicr 	cicr 
ciel 	ciel 
cinéaste 	cinéaste 
cindy 	cindy 
cinglante 	cinglante 
cinq 	cinq 
cinquantaine 	cinquant
cinquante 	cinquant
cinquième 	cinquième 
cio 	cio 
circonspect 	circons
circonstances 	circons
circulaient 	circul
circule 	circul
circulent 	circul
cirque 	cirque 
cisjordanie 	cisjordanie 
cité 	cité 
citant 	citant 
citerne 	citerne 
citées 	citées 
citoyen 	citoyen
citoyens 	citoyen
civil 	civi
civile 	civi
civiles 	civi
civilisé 	civilis
civilisation 	civilis
civils 	civi
civique 	civique
civiques 	civique
clé 	clé 
éclaboussé 	éclabouss
éclaboussée 	éclabouss
éclabousse 	éclabouss
éclair 	écla
éclair 	écla
éclair 	écla
clair 	clair 
clair 	clair 
éclaircissements 	écla
claire 	claire
clairement 	claire
clamé 	clam
clamant 	clam
clamer 	clam
clameur 	clam
clandestine 	clandestin
clandestins 	clandestin
clans 	clan
claque 	claque 
clarence 	clar
clarification 	clar
clarifiée 	clar
clarke 	clar
classé 	class
classe 	class
éclat 	écla
éclat 	écla
éclaté 	écla
éclaté 	écla
éclate 	écla
claude 	clau
claudia 	clau
clause 	clau
clavicule 	clavicule 
célébré 	célébré 
célébraient 	célébra
célébration 	célébration
célébrations 	célébration
célébrée 	célébrée 
célèbre 	célèbre 
célèbre 	célèbre 
célébrer 	célébrer 
célèbres 	célèbres 
célébrité 	célébrité
célébrités 	célébrité
clemenceau 	clemen
clementina 	clemen
célibat 	célibat 
clichés 	clichés 
client 	client
clients 	client
climat 	climat
climatique 	climat
clinton 	clinton 
clip 	clip 
clivage 	clivage 
clémence 	clémence 
cloches 	cloches 
clore 	clore 
clos 	clos 
close 	close 
closes 	closes 
clés 	clés 
clôture 	clôture 
club 	club
clubs 	club
cm 	cm 
cnn 	cnn 
co 	co 
co2 	co2 
coalition 	coalition 
coca 	coca 
cockpit 	cockpit 
cocottes 	cocottes 
code 	code 
coeur 	coeur 
cogite 	cogite 
cohabitation 	cohabitation 
cohn 	cohn 
école 	écol
écoles 	écol
écolière 	écol
colis 	colis 
collaborateurs 	collabor
collaborer 	collabor
collecter 	collect
collectif 	collect
collective 	collect
collège 	collège
collèges 	collège
collimateur 	collimateur 
collines 	collines 
collision 	collision 
colmatées 	colmatées 
écologiste 	écol
cologne 	cologne 
colombie 	colombie
colombien 	colombie
colombienne 	colombie
colon 	colon 
colonel 	colonel 
colonie 	colonie 
colonies 	colonies 
colonisation 	colonisation 
colonne 	colonne 
colons 	colons 
colère 	colère 
columbine 	columbine 
coma 	coma 
combat 	combat
combats 	combat
combattant 	combat
combattants 	combat
combattre 	combat
combustible 	combustible 
comédie 	comédie 
comité 	comité 
commanautés 	comman
commandemants 	comman
commando 	comman
commandos 	comman
comme 	comme 
commençait 	commença
commençant 	commença
commencé 	commencé 
commencée 	commencée 
commence 	commence 
commence 	commence 
commencent 	commencent 
commencer 	commencer 
commencés 	commencés 
comment 	comment 
commentaire 	commentaire
commentaires 	commentaire
commenter 	commenter 
commercial 	commercial
commerciales 	commercial
commettre 	commettre 
commis 	commis
commissaire 	commis
commission 	commis
commémoré 	commémor
commémorant 	commémor
commémoration 	commémor
commémorations 	commémor
commémorent 	commémor
commun 	commun
communauté 	commun
communautaire 	commun
communautaires 	commun
communautés 	commun
commune 	commun
communes 	commun
communication 	commun
communiqué 	commun
communiquée 	commun
communique 	commun
communiquer 	commun
communiqués 	commun
communiste 	commun
communs 	commun
compagnie 	compagn
compagnon 	compagnon
compagnons 	compagnon
comparé 	comparé 
comparaisons 	comparais
comparaissant 	comparais
comparaissent 	comparais
comparaît 	comparaît
comparaître 	comparaît
comparés 	comparés 
comparution 	comparution 
compatriotes 	compatriotes 
compenser 	compenser 
complet 	complet 
complexe 	complexe 
complication 	complication
complications 	complication
complices 	complices 
complicité 	complicité 
compliqué 	compliqu
compliquaient 	compliqu
compliquée 	compliqu
complique 	compliqu
compliquent 	compliqu
complot 	complot 
complétant 	complétant 
complètement 	complètement 
comportait 	comport
comportement 	comportement
comportements 	comportement
composé 	composé 
composants 	composants 
composer 	composer 
composition 	composition 
comprend 	comprend
comprendre 	comprend
compris 	compris 
compromet 	compromet
compromettent 	compromet
compromis 	comprom
comptabilisé 	comptabilis
comptabilise 	comptabilis
comptabilisés 	comptabilis
comptables 	comptables 
comptait 	comptait 
compte 	compte 
compétences 	compétences 
compter 	compter 
comptes 	comptes 
concentration 	conce
concentre 	conce
concentrent 	conce
concept 	conce
concernant 	conce
concernées 	conce
concernés 	conce
concertées 	conce
concerts 	conce
concession 	conce
coïncide 	coïncide
coïncider 	coïncide
conciliation 	conci
concitoyens 	conci
conclave 	concl
conclu 	concl
conclue 	concl
concluent 	concl
conclure 	conclure
conclurent 	conclure
conclusion 	conclusion
conclusions 	conclusion
concret 	concr
concrètes 	concr
concurrents 	concurrents 
condamné 	cond
condamnant 	cond
condamnation 	cond
condamnations 	cond
condamnée 	cond
condamnée 	cond
condamne 	cond
condamne 	cond
condamner 	cond
condamnés 	cond
conde 	cond
condi 	cond
condition 	cond
conditionné 	cond
conditionnant 	cond
conditions 	cond
condoleeza 	cond
condoleezza 	cond
condor 	cond
conduira 	cond
éconduit 	éconduit 
conduit 	cond
conduit 	cond
conduite 	cond
confédération 	conf
confession 	conf
confiance 	conf
confiant 	conf
confidentiel 	conf
confinés 	conf
confirmé 	conf
confirmait 	conf
confirmée 	conf
confirmée 	conf
confirmée 	conf
confirme 	conf
confirme 	conf
confirme 	conf
confirme 	conf
confirment 	conf
confirmer 	conf
conflit 	conf
conflits 	conf
conforme 	conf
conformément 	conf
confortable 	conf
conférence 	conf
confronté 	conf
confrontation 	conf
confrontée 	conf
confrontées 	conf
confrontés 	conf
confrérie 	conf
confusion 	conf
congédier 	cong
congo 	cong
congolais 	cong
congrégation 	cong
congrès 	cong
conjointe 	conjoint
conjoints 	conjoint
connaissance 	conn
connaissent 	conn
connaît 	conn
connaître 	conn
connor 	conn
connotation 	conn
connu 	conn
connue 	conn
connues 	conn
connus 	conn
économie 	économi
économique 	économi
économiques 	économi
économiste 	économi
conquérir 	conquérir 
consacré 	cons
consacrée 	cons
consacrée 	cons
consacre 	cons
consacrés 	cons
conscience 	cons
conscient 	cons
consécutif 	cons
consécutive 	cons
conseil 	cons
conseillé 	cons
conseiller 	cons
conseils 	cons
consensuelle 	cons
consensus 	cons
consentante 	cons
conservateur 	cons
conservateurs 	cons
conservatisme 	cons
conservatrice 	cons
conserve 	cons
conserver 	cons
considéré 	cons
considérable 	cons
considérables 	cons
considération 	cons
considérée 	cons
considère 	cons
considère 	cons
considèrent 	cons
consignes 	cons
consolidé 	cons
consolider 	cons
consommé 	cons
consommation 	cons
conséquence 	cons
conséquences 	cons
constaté 	cons
constatations 	cons
constatée 	cons
constater 	cons
constituaient 	cons
constituait 	cons
constituante 	cons
constitue 	cons
constituent 	cons
constituer 	cons
constitués 	cons
constitution 	cons
constitutionnel 	cons
constructeurs 	cons
construction 	cons
consulat 	cons
consultation 	cons
consultative 	cons
contact 	cont
contact 	cont
contacté 	cont
contactant 	cont
contacter 	cont
contactées 	cont
contacts 	cont
contagion 	cont
contaminée 	cont
contamine 	cont
conte 	cont
contente 	cont
contenter 	cont
contenu 	cont
contesté 	cont
contestataire 	cont
contestée 	cont
contestée 	cont
contestée 	cont
conteste 	cont
conteste 	cont
conteste 	cont
contexte 	cont
continent 	cont
continentale 	cont
contingent 	cont
continué 	cont
continuaient 	cont
continuait 	cont
continue 	cont
continuent 	cont
continuer 	cont
continuera 	cont
contourner 	cont
contradictions 	cont
contradictoires 	cont
contraindre 	cont
contraint 	cont
contrainte 	cont
contraintes 	cont
contraire 	cont
contrairement 	cont
contraires 	cont
contrario 	cont
contrariétés 	cont
contrastant 	cont
contrat 	cont
contre 	cont
contrecarrer 	cont
contredit 	cont
contrepartie 	cont
contres 	cont
contribué 	cont
contributions 	cont
contrôlé 	cont
contrôle 	cont
contrôler 	cont
contrôles 	cont
contrôleur 	cont
controverse 	cont
contumace 	cont
conçus 	conçus 
convaincre 	conv
convalescence 	conv
convalescent 	conv
convention 	conv
conventionnelle 	conv
convergent 	conv
converger 	conv
conversation 	conv
conversations 	conv
conversion 	conv
converti 	conv
convertie 	conv
conviés 	conv
convoi 	conv
convoqué 	conv
convoquée 	conv
convoquer 	conv
convoyé 	conv
cook 	cook 
coopérante 	coopér
coopération 	coopér
coopérer 	coopér
coordonnée 	coordonn
coordonner 	coordonn
écopé 	écopé 
cope 	cope 
copilote 	copilote 
coppenbrügge 	coppenbrügge 
copvilla 	copvilla 
coran 	coran 
corde 	corde 
cordiale 	cordiale 
coréen 	coréen 
écornée 	écornée 
corne 	corne 
corps 	corps 
corrects 	corrects 
correspondante 	correspondante 
corroborer 	corroborer 
corruption 	corruption 
corsair 	corsair 
cortège 	cortège 
écossaise 	écossaise 
coûté 	coût
coûté 	coût
coté 	coté 
coûta 	coût
coûte 	coût
coûte 	coût
cote 	cote 
coûter 	coût
couac 	couac 
coulaient 	coulaient 
écoulée 	écoulée 
coule 	coule 
écoulées 	écoulées 
couleur 	couleur 
coulisses 	coulisses 
coup 	coup 
coup 	coup 
coup  	coup  
coupable 	coupable
coupables 	coupable
coupant 	coupant 
coupée 	coupée 
coupe 	coupe 
couper 	couper 
couple 	couple
couples 	couple
coupés 	coupés 
coups 	coups 
coupure 	coupure
coupures 	coupure
cour 	cour 
courage 	courage 
courant 	courant
courants 	courant
coureur 	coureur 
couronne 	couronn
couronnées 	couronn
courrier 	courrier 
cours 	cours 
course 	course 
court 	court 
écourte 	écourte 
cousin 	cousin 
écoute 	écoute
couteau 	couteau 
écouter 	écoute
écoutes 	écoute
couvert 	couvert
couverts 	couvert
couverture 	couvert
couvrait 	couvrait 
couvre 	couvre 
couvrir 	couvrir 
créé 	créé 
cracovie 	cracovie 
craignant 	craign
craignent 	craign
craindre 	craindre 
craintes 	craintes 
écrans 	écrans 
crapuleux 	crapuleux 
écrasé 	écrasé 
écrase 	écrase
écrasement 	écrase
crash 	crash
crasher 	crash
création 	création
créationnisme 	création
crawford 	crawford 
cérébral 	cérébral
cérébrale 	cérébral
crédité 	créd
crédulité 	créd
crée 	crée
créent 	crée
créer 	crée
creux 	creux 
criaient 	criaient 
criblés 	criblés 
crie 	crie 
crime 	crime 
crimes 	crimes 
criminalité 	crimin
criminelle 	crimin
cris 	cris 
crise 	crise 
crises 	crises 
cristal 	cristal 
écrit 	écrit 
critiqué 	critiqu
critiquée 	critiqu
critique 	critiqu
critique 	critiqu
critiquer 	critiqu
critiquées 	critiqu
critiques 	critiqu
critiques 	critiqu
critères 	critères 
écrivain 	écrivain 
crl 	crl 
cérémonie 	cérémonie
cérémonies 	cérémonie
croate 	croat
croatie 	croat
croient 	croient 
croire 	croire 
croiser 	croiser 
croisière 	croisière 
croissance 	croissan
croissant 	croissan
croit 	croit 
croix 	croix 
cross 	cross 
croyant 	croyant
croyants 	croyant
crs 	crs 
crucial 	crucial
cruciale 	crucial
crue 	crue 
cruelle 	cruelle 
crues 	crues 
crypte 	crypte 
csu 	csu 
côté 	côté 
côte 	côte 
côtes 	côtes 
côtière 	côtière 
côtés 	côtés 
cuba 	cuba
cubain 	cuba
cuisant 	cuis
cuisine 	cuis
culkin 	culkin 
culmine 	culmine 
culpa 	culpa 
culte 	culte 
culture 	culture
culturel 	culture
culturelle 	culture
cur 	cur 
curie 	curie
curieux 	curie
cuves 	cuves 
cyberdissident 	cyberdissident 
cycliste 	cycl
cyclone 	cyclon
cyclones 	cyclon
cyclonique 	cyclon
cynique 	cynique 
cyril 	cyril 
czestochowa 	czestochowa 
d 	d 
d 	d 
d 	d 
d 	d 
d 	d 
d 	d 
d 	d 
d 	d 
d 	d 
d 	d 
d 	d 
d 	d 
d 	d 
d 	d 
d 	d 
d 	d 
d 	d 
d 	d 
d 	d 
d 	d 
d 	d 
d 	d 
d 	d 
d 	d 
d 	d 
d 	d 
d 	d 
d 	d 
d 	d 
d 	d 
d 	d 
d 	d 
d 	d 
d 	d 
d 	d 
dû 	dû 
dû 	dû 
dû 	dû 
dû 	dû 
dû 	dû 
dû 	dû 
dû 	dû 
dû 	dû 
dû 	dû 
dû 	dû 
dû 	dû 
dû 	dû 
dû 	dû 
dû 	dû 
dû 	dû 
dû 	dû 
dû 	dû 
dû 	dû 
dû 	dû 
dû 	dû 
dû 	dû 
dû 	dû 
dû 	dû 
dû 	dû 
dû 	dû 
dû 	dû 
dû 	dû 
dû 	dû 
dû 	dû 
dû 	dû 
dû 	dû 
dû 	dû 
dû 	dû 
dû 	dû 
da 	da 
daily 	daily 
dakar 	dakar 
dallas 	dallas 
damas 	damas 
dame 	dame 
dames 	dames 
dan 	dan 
danemark 	danemark 
danger 	danger
dangereuse 	danger
dangereux 	danger
dangers 	danger
daniel 	daniel 
danois 	danois
danoise 	danois
dans l 	dans l 
danube 	danube 
darom 	darom 
darvwin 	darvwin 
darwin 	darwin 
daté 	daté 
date 	date 
davantage 	davantage 
david 	david 
day 	day 
dayton 	dayton 
débarque 	débarqu
débarqués 	débarqu
débarrasser 	débarrasser 
débat 	débat 
débats 	débats 
débâcle 	débâcle 
débit 	débit 
déblaiement 	débla
déblayer 	déblaye
déblayeurs 	déblaye
déboires 	déboires 
débouché 	débouché 
déboutés 	déboutés 
débranchement 	débranchement 
débusquer 	débusquer 
début 	début 
début 	début 
début 	début 
début 	début 
début 	début 
début 	début 
début 	début 
débuté 	débuté 
débuté 	débuté 
débuté 	débuté 
débuté 	débuté 
débuté 	débuté 
débuté 	débuté 
débuté 	débuté 
débute 	débute 
débuter 	débuter 
débutera 	débutera 
débuteront 	débuteront 
débuts 	débuts 
décédé 	décédé
décédée 	décédé
décembre 	décembre 
décennie 	décennie
décennies 	décennie
décentralisation 	décentralisation 
déception 	déception 
déchaînent 	déchaînent 
décharge 	décharge 
déchu 	déchu 
décidé 	décidé 
décident 	décident 
décider 	décider 
décimée 	décimée 
décision 	décision
décisions 	décision
décisive 	décisi
déclaré 	déclar
déclaration 	déclar
déclarations 	déclar
déclare 	déclar
déclarés 	déclar
déclenché 	déclench
déclenchant 	déclench
déclenche 	déclench
déclenchement 	déclench
décliner 	décliner 
décollage 	décoll
décollent 	décoll
décoller 	décoll
décombres 	décombres 
décompte 	décompte 
découlé 	découlé 
découvert 	découvert
découverte 	découvert
découverts 	découvert
découvre 	découvre 
découvrez 	découvrez 
découvrir 	découvrir 
décret 	décret 
décrisper 	décrisper 
décrit 	décrit 
décrits 	décrits 
décrivent 	décrivent 
décrocher 	décrocher 
décrété 	décrété
décrétés 	décrété
décrue 	décrue 
décryptage 	décrypt
décrypte 	décrypt
décès 	décès 
dédommagements 	dédommagements 
 de 	 de 
 de 	 de 
de 	de 
de 	de 
de 	de 
de 	de 
de 	de 
de 	de 
de 	de 
deçà 	deçà 
deçà 	deçà 
deçà 	deçà 
deçà 	deçà 
de belmarsh 	de belmarsh 
degré 	degré
degrés 	degré
deif 	deif 
dekalim 	dekalim 
dekelim 	dekelim 
del 	del 
de la 	de la 
delagrange 	delagrange 
delay 	delay 
delhi 	delhi 
demain 	demain 
demandé 	demand
demandaient 	demand
demandant 	demand
demande 	demand
demandent 	demand
demander 	demand
demanderait 	demand
demandes 	demand
demeure 	demeure 
demi 	demi 
denis 	denis 
dents 	dents 
depuis 	depuis 
dernier 	dernier
derniers 	dernier
dernière 	dernière
dernièrement 	dernière
dernières 	dernière
derrière 	derrière 
de sang 	de sang 
descendance 	descen
descendus 	descen
descente 	descen
des etats 	des etats 
desquels 	desquels 
dessine 	dessin
dessins 	dessin
destin 	destin 
destin 	destin 
destin 	destin 
destin 	destin 
destiné 	destiné 
destiné 	destiné 
destiné 	destiné 
destiné 	destiné 
destination 	destination 
destinée 	destinée
destinées 	destinée
destinés 	destinés 
destitué 	destitu
destitution 	destitu
destremau 	destremau 
destruction 	destruction
destructions 	destruction
destructrice 	destruct
detlev 	detlev 
dette 	dette 
deuil 	deuil 
deux 	deux 
deuxième 	deuxième 
devaient 	deva
devait 	deva
devancer 	devancer
devancerait 	devancer
 devant 	 devant 
devant 	deva
devant 	deva
devenant 	deven
devenir 	deven
devenu 	deven
devenue 	deven
devenus 	deven
devient 	devient 
devoir 	devoir 
devra 	devr
devraient 	devr
devrait 	devr
devront 	devr
défaillance 	défaillance
défaillances 	défaillance
défaillant 	défaillan
défaite 	défaite 
défaitisme 	défaitisme 
défavorables 	défavor
défavorisée 	défavor
défection 	défection 
défend 	défend 
défendant 	défendant 
défendra 	défendra 
défendre 	défendre 
défendu 	défendu 
défendue 	défendue 
défense 	défense
défenseur 	défenseur
défenseurs 	défenseur
déferlent 	déferlent 
défi 	défi 
défie 	défie 
défient 	défient 
défier 	défier 
défilé 	défilé
défilaient 	défilaient 
défile 	défile
défilent 	défile
défileront 	défile
défilés 	défilé
définit 	définit
définitif 	définit
définitive 	définitive
définitivement 	définitive
défis 	défis 
déflagration 	déflagration 
déformé 	déformé 
déféré 	déféré 
défunt 	défunt 
dégageant 	dégag
dégagés 	dégag
dégel 	dégel 
dégénéré 	dégén
dégénère 	dégén
dégradé 	dégrad
dégradation 	dégrad
dgse 	dgse 
dégât 	dégât
dégâts 	dégât
di 	di 
diabolique 	diabolique 
diagnostic 	diagnostic 
dialogue 	dialogue
dialoguer 	dialogue
dialogues 	dialogue
diana 	diana 
diaporama 	diaporama 
diatribe 	diatribe 
dick 	dick 
dictateur 	dictat
dictature 	dictature
dictatures 	dictature
didier 	didier 
die 	die 
diego 	diego 
dieu 	dieu 
diffamation 	diff
difficile 	diff
difficilement 	diff
difficiles 	diff
difficultés 	diff
différend 	diff
différente 	diff
différentes 	diff
différents 	diff
diffusé 	diff
diffusée 	diff
diffuse 	diff
diffuser 	diff
diffusées 	diff
diffusion 	diff
diffusés 	diff
édifices 	édifices 
digestif 	digestif
digestifs 	digestif
dignitaire 	dignitaire
dignitaires 	dignitaire
diluviennes 	diluviennes 
dimanche 	dimanche
dimanche un 	dimanche
dimension 	dimension 
diminuer 	diminuer 
diocèse 	diocèse 
diplômés 	dipl
diplomate 	diplomat
diplomates 	diplomat
diplomatie 	diplomat
diplomatique 	diplomatique
diplomatiques 	diplomatique
dire 	dire 
direct 	direct
directe 	direct
directement 	direct
directes 	direct
directeur 	direct
direction 	direct
directive 	direct
dirigé 	dirig
dirigée 	dirig
dirigée 	dirig
dirigée 	dirig
dirige 	dirig
dirige 	dirig
dirigeait 	dirigea
dirigeant 	dirigeant
dirigeants 	dirigeant
diriger 	diriger
dirigera 	diriger
discorde 	discorde 
discours 	discours 
discrédit 	discrédit
discréditer 	discrédit
discret 	discret 
discrimination 	discrimination 
discrètes 	discrètes 
discrétion 	discrétion 
disculpe 	disculpe 
discussions 	discussions 
discuter 	discuter 
disent 	disent 
disparition 	dispar
disparu 	dispar
disparue 	dispar
disparues 	dispar
disparus 	dispar
dispensant 	dispens
dispense 	dispens
disposant 	dispos
dispose 	dispos
disposent 	dispos
disposer 	dispos
disposera 	dispos
dispositif 	dispos
disputé 	disput
dispute 	disput
disque 	disque 
dissensions 	dissensions 
dissolution 	dissolution 
dissoudre 	dissoudre 
dissous 	dissous 
dissout 	dissout 
distance 	distance 
distribuée 	distribu
distribution 	distribu
dit 	dit 
dite 	dite 
édition 	édition 
éditorialistes 	éditorialistes 
dits 	dits 
divergeaient 	diverge
divergences 	diverge
divergent 	diverge
divergentes 	diverge
diversité 	diver
divin 	divin 
divisé 	divisé 
divisant 	divisant 
divise 	divise 
divisions 	divisions 
divisés 	divisés 
divulgation 	divulgation 
dix 	dix 
dizaine 	dizaine
dizaines 	dizaine
déjà 	déjà 
djerba 	djerba 
déjeuner 	déjeuner 
djihad 	djihad
djihadistes 	djihad
déjoué 	déjoué
déjouée 	déjoué
déjoués 	déjoué
délai 	délai
délais 	délai
délégation 	délég
délégué 	délég
délibérations 	déli
délibérément 	déli
délicat 	déli
délicate 	déli
délinquants 	déli
délivré 	déli
délivre 	déli
délogé 	délog
déloge 	délog
déluge 	déluge 
démantelé 	démantel
démanteler 	démantel
démantèlement 	démant
démarré 	démarré 
démasqué 	démasqué 
dément 	dément
démentent 	dément
démenti 	dément
démentir 	dément
démentis 	dément
démilitarisée 	démilitarisée 
démineurs 	démineurs 
démission 	démission
démissionné 	démission
démissionnaire 	démission
démissionne 	démission
démissionner 	démission
démissionnera 	démission
démêle 	démêle 
démocrate 	démocrat
démocrates 	démocrat
démocratie 	démocrat
démocraties 	démocrat
démocratique 	démocratique
démocratiquement 	démocratique
démocratisation 	démocrat
démocratiser 	démocrat
démolitions 	démolitions 
démonstration 	démonstrati
démonstrative 	démonstrati
démontrer 	démontrer 
démunis 	démunis 
déneigée 	déneigée 
dîner 	dîner 
dénombre 	déno
dénoncé 	déno
dénonce 	déno
dénoncent 	déno
dénoncer 	déno
dénouement 	déno
dénué 	dénu
dénuement 	dénu
doctrine 	doctrine 
document 	document
documentaire 	document
documents 	document
documentvidéo 	document
dogmes 	dogmes 
doigt 	doigt 
doit 	doit 
doivent 	doivent 
dollars 	dollars 
domaine 	domaine 
domicile 	domicil
domicilié 	domicil
dominé 	dominé 
dominante 	dominante 
domination 	domination 
dominicale 	dominicale 
dominique 	dominique 
dommages 	dommages 
donald 	donald 
donateurs 	donateurs 
donc 	donc 
donné 	donné 
donnaient 	donnaient 
donnant 	donnant 
donnée 	donnée 
donnée 	donnée 
donne 	donne 
donne 	donne 
donne 	donne 
donnent 	donnent 
donner 	donner 
données 	données 
donnés 	donnés 
dons 	dons 
dont 	dont 
dopage 	dopage 
doper 	doper 
dorénavant 	dorénavant 
dos 	dos 
dossier 	dossier
dossiers 	dossier
doter 	doter 
douala 	douala 
douanes 	douanes 
doublé 	doubl
doublant 	doubl
double 	doubl
doucement 	doucement 
douche 	douche 
doudjail 	doudjail 
doujaïl 	doujaïl 
douleur 	douleur 
douri 	douri 
douste 	douste 
doute 	doute
doutent 	doute
doutes 	doute
douzaine 	douzaine 
douze 	douze 
downing 	downing 
doyen 	doyen
doyenne 	doyen
départ 	départ
départageant 	départ
départager 	départ
département 	départ
départs 	départ
dépassé 	dépass
dépassée 	dépass
dépasse 	dépass
dépasser 	dépass
dépêché 	dépêché 
dépendance 	dépendan
dépendante 	dépendan
dépendrait 	dépen
dépenses 	dépen
déphasée 	déphasée 
dépit 	dépit
dépitée 	dépit
déplaçant 	déplaçant 
déplace 	déplace 
déplacement 	déplacement 
déplacer 	déplacer 
déplacés 	déplacés 
déploiement 	déploiement 
déploré 	déploré 
déplorant 	déplorant 
déplore 	déplore 
déplorent 	déplorent 
déplorer 	déplorer 
déployé 	déployé
déployés 	déployé
déposé 	déposé 
déposée 	déposée 
déposée 	déposée 
dépose 	dépose 
déposer 	déposer 
déposition 	déposition 
dépotoir 	dépotoir 
dépouille 	dépouille
dépouillement 	dépouille
déprédations 	déprédations 
dépression 	dépression 
dépôt 	dépôt 
député 	député
députés 	député
déraciné 	déra
déraillé 	déraill
déraille 	déraill
déraillement 	déraill
dramatique 	dramatique 
drame 	drame 
drames 	drames 
drapeaux 	drapeaux 
drastique 	drastique
drastiques 	drastique
dresde 	dres
dressent 	dresse
dresser 	dresse
dresseraient 	dresse
drinking 	drinking 
dérives 	dérives 
drôle 	drôle 
dérobé 	dérobé
dérobés 	dérobé
drogues 	drogues 
droit 	droit
droite 	droit
droits 	droit
déroulé 	dérou
déroulaient 	dérou
déroulée 	dérou
déroulée 	dérou
déroule 	dérou
déroule 	dérou
déroule 	dérou
déroulement 	dérou
déroulent 	dérou
dérouler 	dérou
déroulées 	dérou
dérouté 	dérou
déroute 	dérou
dérouter 	dérou
druze 	druze 
dès 	dès 
désaccord 	désaccord
désaccords 	désaccord
désaffection 	désaffection 
désamiantage 	désamiantage 
désarme 	désarme
désarmement 	désarme
désarroi 	désarroi 
désastre 	désastre
désastreuses 	désastre
désengagement 	désengagement 
désert 	désert
déserté 	désert
désertée 	désert
déserteur 	désert
désertique 	désert
désespérés 	désespérés 
désigné 	désign
désignation 	désign
désignée 	désign
désignent 	désign
désigner 	désign
désigneront 	désign
désignés 	désign
désorganisation 	désor
désormais 	désor
déstabilisation 	déstabilisation 
détaché 	détaché 
détaille 	détail
détails 	détail
détective 	détective 
détenir 	détenir 
détenteurs 	détenteurs 
détention 	détention 
détenu 	détenu 
détenues 	détenues 
détenus 	détenus 
déterminé 	détermin
détermination 	détermin
déterminée 	détermin
déterminer 	détermin
détiendrait 	détiendrait 
détonateur 	détonateur
détonateurs 	détonateur
détourné 	détourn
détournant 	détourn
détournée 	détourn
détournement 	détourn
détourner 	détourn
détresse 	détresse 
détérioration 	détérioration 
détroit 	détroit 
détruire 	détrui
détruit 	détrui
détruite 	détrui
détruits 	détrui
déçu 	déçu 
déçu 	déçu 
déçu 	déçu 
déçu 	déçu 
déçu 	déçu 
du 	du 
du 	du 
du 	du 
du 	du 
du 	du 
du 	du 
du 8 	du 8 
dublin 	dublin 
éducation 	éducation 
duché 	duché 
duck 	duck 
déçue 	déçue 
due 	due 
due 	due 
duekoué 	duekoué 
duel 	duel 
dues 	dues 
du gouvernement 	du gouvernement 
dumas 	dumas 
duplicité 	duplicité 
duquel 	duquel 
duré 	duré 
durand 	duran
durant 	duran
durcit 	durcit 
durée 	durée 
dure 	dure 
durement 	durement 
durent 	durent 
durer 	durer 
dures 	dures 
déçus 	déçus 
dus 	dus 
dévasté 	dévast
dévastateur 	dévast
dévastée 	dévast
dévaste 	dévast
dévastés 	dévast
développé 	développ
développée 	développ
développe 	développ
développement 	développ
développer 	développ
déviance 	déviance 
dynamité 	dynamité 
dysfonctionnements 	dysfonctionnements 
e 	e 
eau 	eau 
eaux 	eaux 
echange 	echange 
echauffourées 	echauffourées 
echec 	echec 
economie 	economie 
ecosse 	ecosse 
edgar 	edgar
edgard 	edgar
edimbourg 	edimbourg 
edmund 	edmund 
eduardo 	eduardo 
education 	education 
effacement 	efface
effacer 	efface
effectifs 	effect
effectué 	effect
effectuait 	effect
effectue 	effect
effectuer 	effect
effectuées 	effect
effectués 	effect
effet 	effet 
effets 	effets 
efficacement 	efficacement 
effondré 	effondr
effondrée 	effondr
effondre 	effondr
effondrement 	effondr
efforçant 	efforçant 
efforcé 	efforcé
efforcés 	efforcé
effort 	effort 
efforts 	efforts 
egée 	egée 
eglise 	eglise 
egypte 	egypt
egyptiens 	egypt
ehud 	ehud 
eilat 	eilat 
el 	el 
elbaradei 	elbaradei 
election 	election
elections 	election
electorale 	elect
elias 	elias 
elisabeth 	elisabeth 
elizabeth 	elizabeth 
elle 	elle
ellen 	elle
elles 	elle
eléments 	eléments 
elu 	elu 
elysée 	elysée 
embargo 	embargo 
embarrassé 	embarrass
embarrassent 	embarrass
embaucher 	embaucher 
emblème 	emblème 
embouteillage 	embouteillage
embouteillages 	embouteillage
embrasé 	embras
embrase 	embras
embrasement 	embras
emeute 	emeute
emeutes 	emeute
emile 	emile 
emilio 	emilio 
emily 	emily 
eminem 	eminem 
emirats 	emirats 
emmené 	emmené 
emotion 	emotion 
emparé 	empar
empare 	empar
empêché 	empêch
empêchent 	empêch
empêcher 	empêch
empêchera 	empêch
empêcherons 	empêch
empereur 	empereur 
empiré 	empiré 
emploi 	emplo
emplois 	emplo
employé 	employé
employée 	employé
employés 	employé
empocher 	empocher 
emporté 	emport
emporte 	emport
emporterait 	emport
emprisonné 	emprisonn
emprisonnée 	emprisonn
emprisonnement 	emprisonn
emprisonnés 	emprisonn
enceinte 	enceinte 
encerclé 	encercl
encerclent 	encercl
encerclés 	encercl
enchaîné 	enchaîné 
enclave 	enclave 
encontre 	encontre 
encore 	encore 
encourus 	encourus 
encyclique 	encyclique 
end 	end 
endeuillée 	endeuillée 
endoctrinement 	endoctrinement 
energie 	energie 
enfant 	enfant
enfants 	enfant
enfer 	enfer 
enfin 	enfin 
enfle 	enfle 
enfoncée 	enfonc
enfonce 	enfonc
engagé 	engag
engagée 	engag
engage 	engag
engagement 	engagement
engagements 	engagement
engagent 	engag
engager 	engag
engagées 	engag
engendrée 	engendrée 
engin 	engin
engins 	engin
england 	england 
englouti 	englouti 
enjeu 	enjeu
enjeux 	enjeu
enlevé 	enlev
enlevée 	enlev
enlever 	enlev
enlevées 	enlev
enlevés 	enlev
enlise 	enlise 
enlèvement 	enlèvement
enlèvements 	enlèvement
ennemi 	ennemi
ennemis 	ennemi
ennepetal 	enne
enquête 	enquête
enquêtes 	enquête
enquêteur 	enquête
enquêteurs 	enquête
enrayer 	enrayer 
enregistré 	enregistr
enregistrée 	enregistr
enregistre 	enregistr
enregistrement 	enregistrement
enregistrements 	enregistrement
enregistrées 	enregistr
enrichissement 	enrichissem
enrichissemnt 	enrichissem
enrôlement 	enrôlement 
enseignante 	enseignant
enseignants 	enseignant
enseignement 	enseign
ensemble 	ensemble 
ensuite 	ensuite 
entamé 	entam
entamée 	entam
entame 	entam
entame 	entam
entament 	entam
entamer 	entam
entamées 	entam
entamés 	entam
entend 	enten
entendaient 	entendai
entendait 	entendai
entendent 	enten
entendre 	enten
entendu 	enten
entendus 	enten
entente 	enten
entier 	entier 
entière 	entière
entièrement 	entière
entouré 	entour
entourage 	entour
entourant 	entour
entoure 	entour
entré 	entré 
entraîné 	entraîn
entraînant 	entraîn
entraînement 	entraîn
entrée 	entrée 
entrée 	entrée 
entrée 	entrée 
entrée 	entrée 
entrée 	entrée 
entrée 	entrée 
entrée 	entrée 
entrée 	entrée 
entrée 	entrée 
entrée 	entrée 
entrée 	entrée 
entrée 	entrée 
entrée 	entrée 
entrée 	entrée 
entre 	entre 
entre 	entre 
entre 	entre 
entre 	entre 
entre 	entre 
entre 	entre 
entre 	entre 
entre 	entre 
entre 	entre 
entre 	entre 
entre 	entre 
entre 	entre 
entre 	entre 
entre 	entre 
entre 	entre 
entrent 	entrent 
entrepreneur 	entrepr
entreprise 	entreprise
entreprises 	entreprise
entrer 	entrer
entrera 	entrer
entrées 	entrées 
entretenant 	entreten
entretenir 	entreten
entretien 	entretien
entretiens 	entretien
entériné 	entérin
entériner 	entérin
entrés 	entrés 
envahi 	envahi
envahisseur 	envahi
enveloppe 	enveloppe 
envergure 	envergure 
enverra 	enverra 
envers 	envers 
envi 	envi 
environ 	environ
environs 	environ
envisagé 	envisag
envisagée 	envisag
envisagée 	envisag
envisage 	envisag
envisage 	envisag
envisage 	envisag
envisagent 	envisag
envisager 	envisag
envoi 	envoi 
envoie 	envoie 
envoyé 	envoyé 
envoyer 	envoyer 
envoyez 	envoyez 
epargnée 	epargnée 
equateur 	equat
equatorienne 	equat
ermite 	ermite 
errant 	errant 
erreur 	erreur
erreurs 	erreur
erronée 	erronée 
erythréens 	erythréens 
escalade 	escal
escale 	escal
escales 	escal
escroquerie 	escroquerie 
espace 	espace 
espagne 	espagn
espagnol 	espagnol
espagnole 	espagnol
espagnols 	espagnol
espionnage 	espion
espionnait 	espion
espionne 	espion
espions 	espion
esplanade 	esplanade 
espoir 	espoir
espoirs 	espoir
espérances 	espérances 
espère 	espère 
espérent 	espérent 
esprit 	esprit 
essai 	essai 
essaiera 	essaiera 
essayé 	essayé 
essayant 	essayant 
essayer 	essayer 
essentiellement 	essentiellement 
estaing 	estaing 
estimé 	estim
estimait 	estim
estimant 	estim
estimation 	estimation
estimations 	estimation
 estime 	 estime 
estime 	estim
estime 	estim
estiment 	estim
eta 	eta 
etait 	etait 
etat 	etat 
etats 	etats 
etchanchu 	etchanchu 
ethiopiens 	ethiopiens 
ethniquement 	ethnique
ethniques 	ethnique
etzion 	etzion 
eu 	eu 
eucharistique 	eucharistique 
euro 	euro
eurodéputés 	euro
euroméditerranée 	euro
euroméditerranéen 	euro
euromed 	euro
europe 	euro
européen 	euro
européenne 	euro
européennes 	euro
européens 	euro
euros 	euro
euthanasie 	euthanasie 
eux 	eux 
evacuation 	evacuation
evacuations 	evacuation
eve 	eve 
eveille 	eveille 
evian 	evian 
evo 	evo 
ex 	ex 
exacerbe 	exacerb
exacerbées 	exacerb
exacte 	exacte
exactement 	exacte
examen 	examen
examens 	examen
examiné 	examin
examinent 	examin
examiner 	examin
examinera 	examin
exception 	exception
exceptionnelle 	exceptionnelle
exceptionnellement 	exceptionnelle
excessif 	excessi
excessive 	excessi
exclamé 	exclamé 
exclu 	exclu 
excluent 	excluent 
exclusion 	exclusi
exclusivement 	exclusi
exclut 	exclut 
excommunié 	excommunié 
excès 	excès 
excusé 	excus
excuse 	excus
excuser 	excus
excuses 	excus
exécuté 	exécut
exécutent 	exécut
exécutif 	exécut
exécution 	exécut
exécutés 	exécut
exemplaire 	exempl
exemple 	exempl
exemples 	exempl
exercice 	exercice
exercices 	exercice
exergue 	exergue 
exhorté 	exhort
exhorte 	exhort
exigé 	exigé 
exigeant 	exigeant 
exiger 	exiger 
exil 	exil 
existé 	exist
existence 	existen
existent 	existen
exode 	exode 
expatriés 	expatriés 
expertise 	expert
experts 	expert
expiré 	expir
expiration 	expir
explication 	explication
explications 	explication
expliqué 	expliqu
expliquant 	expliqu
explique 	expliqu
expliquent 	expliqu
expliquer 	expliqu
expliquerait 	expliqu
exploitant 	exploit
exploitations 	exploit
exploitées 	exploit
explore 	explore 
explosé 	explosé 
exploser 	exploser 
explosif 	explosif 
explosifs 	explosifs 
explosion 	explosion
explosions 	explosion
explosive 	explosive 
expo 	expo 
exportations 	exportations 
exposé 	exposé 
exposée 	exposée 
expose 	expose 
exposition 	exposition
expositions 	exposition
express 	express
expression 	express
expérience 	expérience
expériences 	expérience
exprimé 	exprim
exprimait 	exprim
exprime 	exprim
expulsé 	expuls
expulser 	expuls
expulsera 	expuls
expulsion 	expuls
expulsions 	expuls
exterminées 	exterminées 
extradé 	extradé 
extrade 	extrade 
extrader 	extrader 
extradition 	extradition 
extraire 	extraire 
extraits 	extraits 
extraordinaire 	extraordinaire 
extremis 	extremis 
extérieur 	extérieur 
extrême 	extrême
extrêmement 	extrême
extrémisme 	extrémis
extrémistes 	extrémis
ezzat 	ezzat 
f16 	f16 
façade 	façade 
fabrication 	fabrication 
fabuleux 	fabuleux 
face 	face 
facilement 	facil
facilité 	facilit
faciliter 	facilit
factions 	factions 
facto 	facto 
facultatif 	facultatif 
fahd 	fahd 
faible 	faibl
faibles 	faibl
faiblesse 	faibl
faibli 	faibl
faiblissent 	faibl
faille 	faill
failles 	faill
faillite 	faill
faim 	faim 
fair 	fair 
faire 	faire 
faisait 	faisa
faisant 	faisa
fait 	fait 
faite 	faite 
faits 	faits 
falloujah 	falloujah 
fallu 	fallu 
falsification 	falsification 
fameuse 	fameuse 
familial 	familial
familiales 	familial
famille 	famille
familles 	famille
famine 	famine 
fan 	fan 
fans 	fans 
fantômes 	fantômes 
façon 	façon 
faraj 	faraj 
farc 	farc 
farouche 	farouche 
faruk 	faruk 
fasciné 	fasci
fascisme 	fasci
fastidieux 	fastidieux 
fat 	fat 
fatah 	fatah 
fatale 	fatale 
fatalité 	fatalité 
faucher 	faucher 
faucon 	faucon 
faudra 	faudra
faudrait 	faudra
faure 	faure 
fausse 	fausse
fausses 	fausse
faut 	faut 
faute 	faute 
fauteuil 	fauteuil 
faux 	faux 
faveur 	faveur 
favorable 	favorable
favorablement 	favorable
favorables 	favorable
favori 	favor
favorisant 	favor
favoriser 	favor
favorite 	favor
fbi 	fbi 
fâchent 	fâchent 
fécondation 	fécond
fécondité 	fécond
fédéral 	fédéra
fédérale 	fédéra
fédérales 	fédéra
fédéralisme 	fédéra
fédéraux 	fédéra
felt 	felt 
femme 	femme
femmes 	femme
fenêtre 	fenêtre
fenêtres 	fenêtre
fer 	fer 
fera 	fera 
ferait 	ferait 
fermé 	fermé 
fermée 	fermée 
ferme 	ferme 
ferme 	ferme 
fermement 	fermement 
ferment 	ferment 
fermer 	fermer 
fermées 	fermées 
fermes 	fermes 
fermeture 	fermeture 
fermés 	fermés 
feront 	feront 
ferroviaire 	ferroviaire 
ferry 	ferry 
ferveur 	ferveur 
festive 	festiv
festivités 	festiv
feu 	feu 
feuille 	feuille 
feux 	feux 
fiancée 	fiancée 
fiché 	fich
fichiers 	fich
fidel 	fidel 
fidèle 	fidèle
fidèles 	fidèle
fidélité 	fidélité 
fief 	fief 
fier 	fier 
fierté 	fierté 
figaro 	figaro 
figurait 	figur
figure 	figur
figurent 	figur
figurerait 	figur
fil 	fil 
file 	file 
filet 	filet 
filiale 	filiale 
filière 	filière
filières 	filière
fille 	fille
filles 	fille
fillette 	fille
film 	film 
film 	film 
filmé 	filmé 
filmaient 	filmaient 
filmée 	filmée 
filmer 	filmer 
films 	films 
fils 	fils 
fin 	fin 
finale 	finale 
finalement 	finalement 
finales 	finales 
finalisé 	finalis
finalisation 	finalis
financement 	financ
financer 	financ
finances 	financ
financier 	financier
financiers 	financier
financière 	financière
financières 	financière
fini 	fini 
finir 	finir 
finira 	finira 
finit 	finit 
finlande 	finlande 
fins 	fins 
fisc 	fisc
fiscale 	fiscal
fiscalité 	fiscal
fièvre 	fièvre 
fixé 	fixé 
fixée 	fixée 
fixer 	fixer 
fixeur 	fixeur 
flambée 	flambée 
flammes 	flammes 
flatteur 	flatteur 
fléau 	fléau
fléaux 	fléau
fleuron 	fleuron 
félicitant 	félicit
félicite 	félicit
féliciter 	félicit
fln 	fln 
flops 	flops 
florence 	florence 
floride 	floride 
florilège 	florilège 
florissante 	florissante 
flotte 	flotte
flottement 	flotte
flux 	flux 
féminin 	fémini
féministes 	fémini
focalisée 	focalisée 
foi 	foi 
fois 	fois 
fonce 	fonce 
fonction 	fonction
fonctionné 	fonction
fonctionnement 	fonction
fonctionnent 	fonction
fonctionner 	fonction
fonctions 	fonction
fond 	fond 
fondé 	fondé 
fondamentaliste 	fondamenta
fondamentaux 	fondamenta
fondateur 	fondateur 
fonds 	fonds 
font 	font 
football 	football
footballeur 	footballeur
footballeurs 	footballeur
forçant 	forçant 
forbes 	forbes 
forcé 	forcé 
forcée 	forcée 
force 	force 
force 	force 
forcené 	forcené 
forcer 	forcer 
forces 	forces 
forcément 	forcément 
forcés 	forcés 
formé 	formé 
formait 	formait 
formation 	formation
formations 	formation
forme 	forme 
formelle 	formelle
formellement 	formelle
formelles 	formelle
former 	former 
formidable 	formidable 
formulé 	formul
formule 	formul
forêt 	forêt 
fort 	fort 
fort 	fort 
forte 	forte 
fortement 	fortement 
forteresse 	forteresse
forteresses 	forteresse
fortes 	fortes 
forêts 	forêts 
forts 	forts 
forum 	forum 
forza 	forza 
fossé 	fossé 
fou 	fou 
foucauld 	foucauld 
foudre 	foudre 
foulard 	foulard 
foulée 	foulée 
foule 	foule 
foule 	foule 
fourni 	fourni
fourniret 	fourni
fournitures 	fourni
foyer 	foyer
foyers 	foyer
fr 	fr 
fragile 	fragil
fragilisé 	fragilis
fragilisée 	fragilis
fragilise 	fragilis
français 	français
française 	français
françaises 	français
france 	france 
francesco 	francesco 
francfort 	francfort 
franchi 	franchi
franchie 	franchi
franchissent 	franchi
franchit 	franchi
franciliennes 	franciliennes 
francisco 	francisco 
franco 	franco 
francophone 	francophone
francophones 	francophone
francs 	francs 
frange 	frange 
françois 	françois 
franz 	franz 
frappé 	frapp
frappait 	frapp
frappant 	frapp
frappée 	frapp
frappée 	frapp
frappée 	frapp
frappe 	frapp
frappe 	frapp
frappe 	frapp
frappent 	frapp
frapper 	frapp
frappera 	frapp
frappées 	frapp
frappées 	frapp
frappes 	frapp
frappes 	frapp
frappés 	frapp
fraude 	fraud
fraudes 	fraud
fraudeurs 	fraud
frauduleuses 	fraud
frayeur 	frayeur 
freiner 	freiner 
férié 	férié 
frictions 	frictions 
frôlant 	frôlant 
frôlent 	frôlent 
froid 	froid 
front 	front
frontalière 	front
frontalières 	front
frontière 	front
frontières 	front
fréquemment 	fréque
fréquenté 	fréquenté
fréquentées 	fréquenté
frère 	frère
frères 	frère
fruit 	fruit 
fsb 	fsb 
fête 	fête
fêtes 	fête
fugitif 	fugitif 
fugueuse 	fugueuse 
fuient 	fuient 
fuir 	fuir 
fuite 	fuite 
fuji 	fuji 
fulgurante 	fulgurante 
fumée 	fumée 
fumer 	fumer 
fumées 	fumées 
fumeurs 	fumeurs 
funèbre 	funèbre
funèbres 	funèbre
funérailles 	funérailles 
furent 	furent 
fusillade 	fusillade
fusillades 	fusillade
fusils 	fusil
fustigé 	fustigé 
fut 	fut 
futur 	futur
future 	futur
fuyaient 	fuya
fuyant 	fuya
février 	février 
âgé 	âgé 
âgé 	âgé 
g 	g 
g5 	g5 
g8 	g8 
gabon 	gabon
gabonais 	gabon
gadgets 	gadgets 
gadid 	gadid 
gaghan 	gaghan 
gagné 	gagné 
gagnant 	gagnant
gagnante 	gagnant
gagnantes 	gagnant
gagne 	gagne 
gagnent 	gagnent 
gagner 	gagner 
gagneront 	gagneront 
gains 	gains 
gala 	gala
galatasaray 	gala
également 	égal
égalerait 	égal
égalité 	égal
galles 	gall
galloway 	gall
galère 	galère
galèrent 	galère
gandhi 	gandhi 
gang 	gang 
gangster 	gangster 
géant 	géant
géante 	géant
géantes 	géant
garang 	garan
garantir 	garan
égard 	égard 
gardait 	gardait 
gardant 	gardant 
garde 	garde 
garder 	garder 
gardera 	gardera 
gardes 	gardes 
gardien 	gardien
gardiens 	gardien
gare 	gare 
gares 	gares 
garçon 	garçon
garçonnet 	garçon
égarés 	égarés 
gary 	gary 
gastronomie 	gastronomie 
gates 	gates 
gauche 	gauche 
gaulle 	gaulle 
gay 	gay 
gays 	gays 
gaz 	gaz 
gaza 	gaza 
gaze 	gaze 
gazier 	gazier 
gazière 	gazière
gazières 	gazière
gazoduc 	gazoduc
gazoducs 	gazoduc
gazprom 	gazprom 
gbagbo 	gbagbo 
gâchis 	gâchis 
gcse 	gcse 
âgée 	âgée 
âge 	âge 
gebran 	gebran 
geert 	geert 
geisha 	geisha
geishas 	geisha
gel 	gel 
gelé 	gelé
geler 	geler 
geôliers 	geôliers 
gelés 	gelé
gemelli 	gemelli 
geneviève 	geneviève 
genre 	genre
genres 	genre
gens 	gens 
genève 	genève 
george 	george
georges 	george
geothe 	geothe 
gerhard 	gerhard 
gerth 	gerth 
geste 	gest
gestion 	gestion
gestionnaire 	gestion
ghandour 	ghandour 
ghazi 	ghazi 
ghraib 	ghraib 
gi 	gi 
égide 	égide 
giflent 	giflent 
gigantesque 	gigantesque 
gign 	gign 
gil 	gil 
gilchrist 	gilchrist 
gilles 	gilles 
girls 	girls 
giscard 	giscard 
giuliana 	giuli
giulio 	giuli
glacial 	glacial
glaciale 	glacial
glaciales 	glacial
glamour 	glamour 
gèle 	gèle 
gleneagles 	gleneagles 
église 	église
églises 	église
glissement 	glissement
glissements 	glissement
glitter 	glitter 
global 	global
globale 	global
globalement 	global
globalisation 	global
globe 	globe 
gloire 	gloire 
gloria 	gloria 
gnassingbé 	gnassingbé 
gênée 	gênée 
génocidaire 	génocid
génocide 	génocid
généré 	généré 
général 	général 
générale 	générale 
générales 	générales 
généralisée 	généralisée 
génération 	génération 
généraux 	généraux 
générosité 	générosité 
génétiques 	génétiques 
godes 	godes 
goethe 	goethe 
gogh 	gogh 
géographie 	géographie 
goldsmith 	goldsmith 
golfe 	golfe 
golias 	golias 
gongadzé 	gongadzé 
gonnet 	gonnet 
gorge 	gorge 
géorgie 	géorgie 
égoïsmes 	égoïsmes 
gotovina 	gotovina 
goulag 	goulag 
goush 	goush 
gouverné 	gouvern
gouvernator 	gouvern
gouvernement 	gouvernement
gouvernementale 	gouvernement
gouvernementales 	gouvernement
gouvernementaux 	gouvernement
gouvernements 	gouvernement
gouverner 	gouvern
gouverneur 	gouvern
governator 	governator 
gq 	gq 
grace 	grace 
gracié 	gracié 
gracier 	gracier 
gradé 	gradé
gradés 	gradé
grand 	grand 
grande 	grande 
grandes 	grandes 
grandi 	grandi 
grandit 	grandit 
grands 	grands 
graner 	graner 
gras 	gras 
grassement 	grassement 
gratitude 	gratitude 
gratte 	gratte 
grave 	grave 
graves 	graves 
gravissime 	gravissime 
grâce 	grâce 
gère 	gère 
grec 	grec 
grecque 	grecque
grecques 	grecque
grecs 	grecs 
greenpeace 	greenpeace 
grenade 	grenade
grenades 	grenade
grégoire 	grégoire 
égérie 	égérie 
grilles 	grilles 
grimper 	grimper 
grise 	grise 
grièvement 	grièvement 
gronder 	gronder 
gros 	gros 
grosse 	grosse 
grotte 	grotte
grottes 	grotte
groupe 	group
groupes 	group
groupuscules 	group
grève 	grève 
guadalajara 	guadalajara 
guantanamo 	guantanamo 
guardian 	guardian 
guatemala 	guatemala 
gueorgui 	gueorgui 
guerbouzi 	guerbouzi 
guerre 	guerre
guerres 	guerre
guide 	guide
guideront 	guide
guinée 	guinée 
guiness 	guiness 
guère 	guère 
guérilla 	guérill
guérilleros 	guérill
gutierrez 	gutierrez 
égyptien 	égyptien
égyptienne 	égyptien
égyptiennes 	égyptien
égyptiens 	égyptien
h 	h 
habemus 	habemus 
habilité 	habilité 
habiller 	habiller 
habitante 	habitant
habitants 	habitant
habitation 	habitation
habitations 	habitation
habite 	habite 
habités 	habités 
habitude 	habitude 
habitués 	habitués 
habré 	habré 
hachémi 	hachémi 
hadera 	hadera 
haine 	haine 
haitang 	haitang 
halberstadt 	halberstadt 
halim 	halim
halimi 	halim
hall 	hall 
hallucinogène 	hallucinogène 
hamas 	hamas 
hambourg 	hambourg 
hamid 	hamid 
hampton 	hampton 
haniyeh 	haniyeh 
hanoun 	hanoun 
hanovre 	hanovre 
hans 	hans 
happy 	happy 
harbour 	harbour 
hariri 	hariri 
harman 	harman 
harmonisation 	harmonis
harmoniser 	harmonis
haro 	haro 
haroon 	haroon 
harriet 	harriet 
hasard 	hasard 
hassan 	hassan 
haïti 	haïti
haïtienne 	haïtien
haïtiens 	haïtien
hausse 	hausse 
haut 	haut 
haute 	haute 
hautement 	hautement 
hauteur 	hauteur 
hauts 	hauts 
hawi 	hawi 
hayam 	hayam 
hayari 	hayari 
haye 	haye 
hébergement 	hébergement
hébergements 	hébergement
hébreu 	hébreu 
hébron 	hébron 
heathrow 	heathrow 
hebdomadaire 	hebdomadaire 
hectares 	hectares 
helios 	helios 
henri 	henri 
hercules 	hercules 
hervé 	hervé 
hesbollah 	hesbollah 
heure 	heur
heures 	heur
heureux 	heur
heurté 	heur
heurte 	heur
heurts 	heur
hexagone 	hexagone 
hezbollah 	hezbollah 
hier 	hier 
hill 	hill
hilla 	hill
hillary 	hill
hindoue 	hindou
hindous 	hindou
hiroshima 	hiroshima 
hissène 	hissène 
histoire 	histo
historien 	histori
historique 	historique
historiquement 	historique
historiques 	historique
hitler 	hitl
hitlériennes 	hitl
hiver 	hiver 
hélicoptère 	hélicoptère
hélicoptères 	hélicoptère
hémorragie 	hémorragie 
holding 	holding 
hollande 	hollande 
hollywood 	hollywood 
holocauste 	holocauste 
homes 	homes
homesh 	homes
homicide 	homicide 
homélie 	homélie 
hommage 	hommage
hommages 	hommage
homme 	homme 
hommes 	hommes 
homologue 	homologue 
homonyme 	homonyme 
homophobe 	homophobe 
homosexualité 	homosexu
homosexuel 	homosexuel
homosexuelle 	homosexuel
homosexuelles 	homosexuel
homosexuels 	homosexuel
hongroisont 	hongroisont 
honneur 	honneur 
honorable 	honor
honore 	honor
honte 	honte 
horizon 	horizon 
hormis 	hormis 
horreur 	horreur 
hors 	hors 
hosni 	hosni 
hospitalier 	hospitali
hospitalisé 	hospitali
hospitalisation 	hospitali
hospitalisée 	hospitali
hospitalisées 	hospitali
hospitalisés 	hospitali
hostile 	hostil
hostilité 	hostil
houleuse 	houleu
houleux 	houleu
houston 	houston 
howard 	howard 
hôpital 	hôpita
hôpitaux 	hôpita
héraut 	héraut 
héros 	héros 
hésité 	hésit
hésite 	hésit
hôte 	hôte
hôtel 	hôte
hôtelière 	hôte
hôtels 	hôte
hétéros 	hétéros
hétérosexuels 	hétéros
huang 	huang 
huées 	huées 
hugo 	hugo 
hui 	hui 
huilées 	huilées 
huis 	huis 
huit 	huit 
huitième 	huitième 
huma 	huma 
humain 	humain
humaine 	humain
humaines 	humain
human 	human 
humanité 	humanit
humanitaire 	humanitaire
humanitaires 	humanitaire
humilié 	humili
humiliant 	humili
humilier 	humili
hussein 	hussein 
hutus 	hutus 
hygiène 	hygiène 
hypothèse 	hypothèse
hypothèses 	hypothèse
ian 	ian 
ibrahim 	ibrahim 
ici 	ici 
icône 	icône 
idéaux 	idéaux 
idée 	idée 
idem 	idem 
identifié 	identi
identification 	identi
identifiée 	identi
identifiées 	identi
identifiés 	identi
identique 	identi
identité 	identi
idées 	idées 
idole 	idole 
iekhanourov 	iekhanourov 
ifri 	ifri 
ignoraient 	ignor
ignore 	ignor
ignorés 	ignor
ii 	ii 
iii 	iii 
ilan 	ilan 
ile 	ile 
ilham 	ilham 
illégal 	illégal
illégalement 	illégal
illégales 	illégal
illégitime 	illég
ils 	ils 
iltaiens 	iltaiens 
image 	image
images 	image
imam 	imam 
imbroglio 	imbroglio 
imitateur 	imitateur 
immédiat 	immédiat
immédiate 	immédiat
immédiatement 	immédiat
immédiatemment 	immédiat
immense 	immense
immenses 	immense
immeuble 	immeuble
immeubles 	immeuble
immigrants 	immigr
immigration 	immigr
immigrés 	immigr
imminent 	imminent
imminente 	imminent
immobilier 	immobili
immobilisé 	immobilisé
immobilisés 	immobilisé
immunité 	immunité 
impact 	impact
impacts 	impact
impardonnable 	impardonnable 
impasse 	impass
impassible 	impass
implantations 	implantations 
implication 	implication 
implicitement 	implicitement 
impliqué 	impliqu
impliquant 	impliqu
impliquer 	impliqu
impliqués 	impliqu
imploré 	imploré 
impopularité 	impopularité 
importance 	importan
important 	importan
importantes 	importan
importants 	importan
importer 	import
imposé 	imposé 
imposant 	imposant 
imposée 	imposée 
imposée 	imposée 
impose 	impose 
impose 	impose 
imposent 	imposent 
imposer 	imposer 
imposés 	imposés 
impotent 	impotent 
impression 	impression
impressionnant 	impressionnant
impressionnantes 	impressionnant
imprimé 	imprimé 
impulsion 	impulsion 
imputé 	imputé 
in 	in 
inacceptable 	inacceptable
inacceptables 	inacceptable
inaccessibles 	inacce
inadmissibles 	inadmissibles 
inapte 	inapte
inaptes 	inapte
inattendu 	inattendu
inattendue 	inattendu
inauguré 	inaugur
inaugurale 	inaugur
inaugurant 	inaugur
inauguration 	inaugur
inaugure 	inaugur
incapable 	incapa
incapacité 	incapa
incarcéré 	incarcéré 
incarnait 	incarnait 
incendié 	incendi
incendie 	incendi
incendiées 	incendi
incendiées 	incendi
incendies 	incendi
incendies 	incendi
incertain 	incertain 
inchangé 	inchangé 
incident 	incident
incidents 	incident
incitation 	incitation 
inciter 	inciter 
inclinée 	inclin
incliner 	inclin
incohérences 	incohérences 
incompétence 	incompétence 
inconnu 	inconnu
inconnue 	inconnu
inconnues 	inconnu
inconnus 	inconnu
incontournable 	incontournable 
incontrôlable 	incontrôlable 
inculpé 	inculp
inculpation 	inculp
inculpations 	inculp
inculpée 	inculp
inculper 	inculp
inculpés 	inculp
incursions 	incursions 
indécis 	indécis
indécision 	indécis
inde 	inde 
indemnes 	indemn
indemnités 	indemn
independent 	independent 
indications 	indications 
indices 	indices 
indien 	indien
indienne 	indien
indiennes 	indien
indiens 	indien
indignée 	indignée 
indiqué 	indiqu
indiquant 	indiqu
indique 	indiqu
indiquent 	indiqu
indiquer 	indiqu
indirectes 	indirectes 
inédite 	inédite
inédites 	inédite
individu 	individu 
indélicate 	indélicate 
indonésie 	indonésie
indonésien 	indonésie
indonésienne 	indonésie
indépendance 	indépendan
indépendant 	indépendan
indépendante 	indépendan
indépendantiste 	indépendan
indéterminée 	indéterminée 
indulgent 	indulgent 
industrialisés 	industri
industrie 	industri
industriel 	industri
industriels 	industri
inexactitudes 	inex
inexplicables 	inex
inexpérimentés 	inex
infectieux 	infecti
infection 	infecti
infiltration 	infiltr
infiltrer 	infiltr
infirmières 	infirmières 
infligé 	inflig
infligeant 	inflig
infligées 	inflig
infligés 	inflig
influence 	influe
influent 	influe
influente 	influe
influer 	influe
info 	info 
infographie 	infographie 
information 	information
informations 	information
informel 	informel 
informent 	informent 
informées 	informées 
infortunés 	infortunés 
infrastuctures 	infrastuctures 
inférieur 	inférieur 
infructueuse 	infructueuse 
inégalités 	inégalités 
ingénieur 	ingénieur 
ingérence 	ingérence 
ingrid 	ingrid 
inhabituellement 	inhabituellement 
inhalé 	inhalé 
inhumé 	inhum
inhumaine 	inhum
inhumation 	inhum
initative 	init
initiale 	initiale
initialement 	initiale
initiatique 	initiati
initiative 	initiati
initiée 	init
injecter 	inject
injection 	inject
injuste 	injuste 
inlassable 	inlassable 
inn 	inn 
innocence 	innocen
innocent 	innocen
inoculé 	inoculé 
inondables 	inond
inondation 	inondation
inondations 	inondation
inondée 	inond
inondés 	inond
inouï 	inouï 
inquiet 	inquiet 
inquiété 	inquiété 
inéquitable 	inéquitable 
inquiétait 	inquiéta
inquiétant 	inquiéta
inquiète 	inquiète
inquiètent 	inquiète
inquiétude 	inquiétude
inquiétudes 	inquiétude
inès 	inès 
insectes 	insect
insecticides 	insect
insel 	insel 
insinué 	insinué 
insisté 	insist
insistance 	insist
inspecteurs 	inspect
inspections 	inspect
inspire 	inspire 
instabilité 	instabilité 
installé 	install
installation 	install
installations 	install
installée 	install
installer 	install
installés 	install
instamment 	instamment 
instant 	instant 
instar 	instar 
instauré 	instaur
instaurant 	instaur
instauration 	instaur
instigateurs 	instigateurs 
institut 	institut
institution 	institution
institutionnelle 	institution
institutions 	institution
instruction 	instru
instrumentalisée 	instrument
instruments 	instrument
insu 	insu 
insubmersible 	insubmersible 
insuffisamment 	insuffisa
insuffisant 	insuffisa
insuffler 	insuff
insultantes 	insultantes 
insurgés 	insurgés 
insurrection 	insurrection
insurrectionnelle 	insurrection
intangibilité 	intangibilité 
intelligence 	intelligence 
intempestive 	intemp
intempéries 	intemp
intense 	intense 
intenses 	intenses 
intensifie 	intensifie
intensifier 	intensifie
intensité 	intensité 
intenté 	intenté 
intention 	intention 
inter 	inter 
interactif 	interactif 
intercepté 	intercepté 
interconfessionnels 	interconfessionnels 
interdiction 	interdi
interdire 	interdi
interdisant 	interdi
interdit 	interdi
interdite 	interdi
interdites 	interdi
interdits 	interdi
interethnique 	interethnique
interethniques 	interethnique
interminable 	interminable 
international 	internationa
internationale 	internationa
internationales 	internationa
internationaux 	internationa
internautes 	internautes 
interne 	interne 
internet 	internet 
interpalestinien 	interpalestinien 
interpellé 	interpell
interpellent 	interpell
interpellées 	interpell
interpellés 	interpell
interposée 	interposée 
interprète 	interprète 
interrogé 	interrogé 
interrogatoire 	interrogatoire
interrogatoires 	interrogatoire
interrogée 	interrogée 
interroge 	interroge 
interrogent 	interrogent 
interroger 	interroger 
interrogées 	interrogées 
interrogés 	interrogés 
interrompu 	interrompu
interrompue 	interrompu
interruption 	interruption 
intervention 	intervention
interventions 	intervention
intervenus 	interven
interviennent 	intervie
intervient 	intervie
interview 	intervie
interviews 	intervie
intégral 	intégr
intégrante 	intégr
intégration 	intégr
intégrer 	intégr
intifada 	intifada 
intime 	intime 
intimidations 	intimidations 
intimité 	intimité 
intitulé 	intitulé 
intoxication 	intoxication 
intransigeance 	intransigean
intransigeant 	intransigean
intérieur 	intérieur
intérieure 	intérieur
intérim 	intéri
intérimaire 	intéri
intronisé 	intronis
intronisation 	intronis
intérêt 	intérêt
intérêts 	intérêt
invalidité 	invalidité 
inverser 	invers
inversion 	invers
investi 	investi
investissement 	investi
investissent 	investi
investiture 	investi
invité 	invit
inévitable 	inévitable 
invitation 	invit
invités 	invit
invoquant 	invoqu
invoquer 	invoqu
invérifiable 	invérifiable 
iouchtchenko 	iouchtchenko 
ioukos 	ioukos 
ioulia 	ioulia 
iouri 	iouri 
ira 	ira 
irak 	irak 
irakien 	irakien
irakienne 	irakien
irakiennes 	irakien
irakiens 	irakien
iran 	iran 
iranien 	iranien
iranienne 	iranien
iraniennes 	iranien
iraniens 	iranien
iris 	iris 
irlandais 	irlandais
irlandaise 	irlandais
irlande 	irland
irrespect 	irrespect 
irréversible 	irréversible 
isabelle 	isabelle 
islam 	islam
islamabad 	islam
islamique 	islam
islamiques 	islam
islamisme 	islam
islamiste 	islam
islamistes 	islam
islamiyah 	islam
islmabad 	islmabad 
ismaïl 	ismaïl 
isolée 	isolé
isolées 	isolé
isolés 	isolé
ispahan 	ispahan 
israël 	israël 
israélien 	israélien
israélienne 	israélien
israéliennes 	israélien
israéliens 	israélien
israélo 	israélo 
isreaélienne 	isreaélienne 
issu 	issu
issue 	issu
istanbul 	istanbul 
istendael 	istendael 
italia 	itali
italie 	itali
italien 	itali
italienne 	italienne
italiennes 	italienne
italiens 	itali
iter 	iter 
itinéraire 	itinéraire 
ituri 	ituri 
ive 	ive 
ivoire 	ivoir
ivoirien 	ivoirien
ivoirienne 	ivoirien
ivoiriens 	ivoirien
j 	j 
jaafari 	jaafari 
jack 	jack 
jackson 	jackson 
jacqueline 	jacque
jacques 	jacque
jacquet 	jacque
jakarta 	jakarta 
jalal 	jalal 
jalonnée 	jalonnée 
jamaah 	jamaah 
jamais 	jamais 
jamaïque 	jamaïque 
james 	james 
janabi 	janabi 
janvier 	janvier 
japon 	japon
japonais 	japonais
japonaise 	japonais
japonaises 	japonais
jaune 	jaune 
jazira 	jazira 
je 	je 
jean 	jean 
jeb 	jeb 
jeff 	jeff 
jenifer 	jenifer 
jennifer 	jennifer 
jet 	jet 
jeté 	jeté 
jetée 	jetée 
jette 	jette 
jeu 	jeu 
jeudi 	jeudi 
jeune 	jeune
jeunes 	jeune
jeunesse 	jeunesse
jeunesses 	jeunesse
jeux 	jeux 
jheloum 	jheloum 
jihad 	jihad 
jilbab 	jilbab 
jill 	jill 
jimbaran 	jimbaran 
jmj 	jmj 
jénine 	jénine 
jo 	jo 
joaquin 	joaquin 
johannesburg 	johannesburg 
john 	john 
johnson 	johnson 
joie 	joie 
joindre 	joindre 
joint 	joint 
jonction 	jonction 
jordanie 	jordanie
jordanien 	jordanie
jordanienne 	jordanienne
jordaniennes 	jordanienne
josé 	josé 
joseph 	joseph 
josh 	josh 
joué 	joué 
jouant 	jouant 
jouée 	jouée 
joue 	joue 
jouent 	jouent 
jouer 	jouer 
joueur 	joueur
joueurs 	joueur
joumblatt 	joumblatt 
jounieh 	jounieh 
jour 	jour 
journal 	journal 
journaliste 	journaliste
journalistes 	journaliste
journaux 	journaux 
journée 	journée
journées 	journée
jours 	jours 
joute 	joute 
jovial 	jovial 
joyeuses 	joyeu
joyeux 	joyeu
jéricho 	jéricho 
jérusalem 	jérusalem 
jésus 	jésus 
jt 	jt 
juba 	juba 
judiciaire 	judiciaire
judiciaires 	judiciaire
judicieux 	judici
jugé 	jugé 
jugée 	jugée 
jugée 	jugée 
jugée 	jugée 
jugée 	jugée 
jugée 	jugée 
jugée 	jugée 
juge 	juge 
juge 	juge 
juge 	juge 
juge 	juge 
juge 	juge 
juge 	juge 
jugeant 	jugeant 
jugement 	jugement 
jugent 	jugent 
juger 	juger 
juges 	juges 
jugez 	jugez 
jugés 	jugés 
juif 	juif 
juifs 	juifs 
juillet 	juillet 
juin 	juin 
juive 	juive
juives 	juive
julia 	julia 
july 	july 
juncker 	juncker 
junichiro 	junichiro 
juridiction 	juridi
juridique 	juridi
juristes 	juristes 
jurés 	jurés 
jury 	jury 
jusqu 	jusqu
jusque 	jusqu
juste 	juste 
justes 	justes 
justesse 	justesse 
justice 	justice 
justifié 	justifi
justifie 	justifi
justifier 	justifi
jyllands 	jyllands 
kabardino 	kabardino 
kabatiya 	kabatiya 
kaboul 	kaboul 
kaczynski 	kaczynski 
kaderim 	kaderim 
kadima 	kadima 
kamala 	kamala 
kamikaze 	kamikaze
kamikazes 	kamikaze
kamtchatka 	kamtchat
kamtchatski 	kamtchat
kanaan 	kanaan 
kansas 	kansas 
karachi 	karachi 
karamé 	karamé 
karimov 	karimov 
karl 	karl 
karol 	karol 
karthago 	karthago 
karzai 	karzai 
kaslik 	kaslik 
katmandou 	katmandou 
katouchia 	katouchia 
katrina 	katrina 
katsav 	katsav 
katzav 	katzav 
kazimierz 	kazimierz 
kelly 	kelly 
ken 	ken 
kennedy 	kenne
kenneth 	kenne
kent 	kent 
kenya 	kenya 
kerem 	kerem 
keys 	keys 
kfar 	kfar
kfarchouba 	kfar
khaddam 	khaddam 
khalili 	khalili 
khan 	khan 
khartoum 	khartoum 
khodorkovski 	khodorkovski 
khoshaba 	khoshaba 
kidnappée 	kidnapp
kidnappeurs 	kidnapp
kidnapping 	kidnapp
kiev 	kiev 
kill 	kill 
killen 	killen 
killer 	killer 
kilomètre 	kilomètre
kilomètres 	kilomètre
kilos 	kilos 
king 	king 
kirghiz 	kirghiz
kirghizstan 	kirghiz
kirkouk 	kirkouk 
kissoufim 	kissoufim 
kkk 	kkk 
klan 	klan 
klaus 	klaus 
klux 	klux 
km 	km 
knesset 	knesset 
kényane 	kényane 
ko 	ko 
kofi 	kofi 
koizumi 	koizumi 
kosovo 	kosovo 
kouchner 	kouchner 
kourmanbek 	kourmanbek 
koursk 	koursk 
koweït 	koweït
koweïtienne 	koweït
kravtchenko 	kravtchenko 
kremlin 	kremlin 
kérosène 	kérosène 
ku 	ku 
kurde 	kurde 
kusadasi 	kusadasi 
kuta 	kuta 
kyoto 	kyoto 
kyushu 	kyushu 
l 	l 
l 	l 
l 	l 
l 	l 
l 	l 
l 	l 
l 	l 
l 	l 
l 	l 
l 	l 
l 	l 
l 	l 
l 	l 
l 	l 
l 	l 
l 	l 
l 	l 
l 	l 
l 	l 
l 	l 
l 	l 
l 	l 
l 	l 
là 	là 
là 	là 
là 	là 
là 	là 
là 	là 
là 	là 
là 	là 
là 	là 
là 	là 
là 	là 
là 	là 
là 	là 
là 	là 
là 	là 
là 	là 
là 	là 
là 	là 
là 	là 
là 	là 
là 	là 
là 	là 
là 	là 
labé 	labé 
élaboré 	élaboré 
élaborer 	élaborer 
laborieux 	laborieux 
labour 	labour 
lac 	lac 
laïcité 	laïcité 
lacunes 	lacunes 
laden 	laden 
lafaille 	lafaille 
lagos 	lagos 
lahore 	laho
lahoud 	laho
laissé 	laiss
laissaient 	laiss
laissant 	laiss
laissée 	laiss
laisse 	laiss
laisser 	laiss
laissera 	laiss
laisseront 	laiss
laissées 	laiss
laissons 	laiss
lake 	lake 
lamentations 	lamentations 
élan 	élan 
lançait 	lançait 
lancé 	lancé 
lancée 	lancée 
lancée 	lancée 
lancée 	lancée 
lancée 	lancée 
lance 	lance 
lance 	lance 
lance 	lance 
lance 	lance 
lance 	lance 
lancement 	lancement 
lancer 	lancer 
lancées 	lancées 
lancés 	lancés 
lanka 	lanka 
laïque 	laïque 
laquelle 	laquelle 
laïques 	laïques 
large 	large
largement 	large
élargie 	élargi
élargissement 	élargi
largués 	largués 
larijani 	larijani 
larmes 	larmes 
larry 	larry 
las 	las 
latin 	lati
latine 	lati
latino 	lati
latitude 	lati
laurence 	laurence 
lauro 	lauro 
lausanne 	lausanne 
law 	law 
laxiste 	laxiste 
lâcher 	lâche
lâchez 	lâche
lci 	lci 
île 	île 
île 	île 
île 	île 
île 	île 
île 	île 
île 	île 
île 	île 
île 	île 
île 	île 
île 	île 
île 	île 
île 	île 
île 	île 
île 	île 
île 	île 
île 	île 
île 	île 
le 	le 
le 	le 
le 	le 
le 	le 
le 	le 
le 	le 
le 	le 
le 	le 
le 	le 
le 	le 
le 	le 
le 	le 
le 	le 
le 	le 
le 	le 
le 	le 
le 	le 
le 	le 
leader 	leader
leaders 	leader
leandro 	leandro 
le bouclage 	le bouclage 
lech 	lech 
lecomte 	lecomte 
leconte 	leconte 
électeurs 	électeurs 
électeurs 	électeurs 
lecteurs 	lecteurs 
élection 	élection
élections 	élection
électoral 	électora
électorale 	électora
électorales 	électora
électorat 	électora
électricien 	électrici
électricité 	électrici
électrique 	électri
lecture 	lecture 
leeds 	leeds 
lendemain 	lendemain 
lennon 	lennon 
lenrichissement 	lenrichissement 
lente 	lente 
lentement 	lentement 
lenteur 	lenteur 
lents 	lents 
leo 	leo 
leonardo 	leonardo 
leçons 	leçons 
lequel 	lequel 
îles 	îles 
les 	les 
les 	les 
lesbien 	lesbien
lesbienne 	lesbien
lesquelles 	lesquel
lesquels 	lesquel
lettre 	lettre 
leur 	leur
leurs 	leur
élevé 	élevé 
levé 	levé 
levant 	levant 
élevée 	élevée 
élevée 	élevée 
élevée 	élevée 
levée 	levée 
levée 	levée 
levée 	levée 
lever 	lever 
éleveur 	éleveur 
élevés 	élevés 
levés 	levés 
lewis 	lewis 
leydier 	leydier 
légal 	légal 
légalisation 	légalisation 
légalité 	légalité 
légaux 	légaux 
léger 	léger
légers 	léger
légion 	légion 
législatif 	législati
législatifs 	législati
législation 	législati
législative 	législati
législatives 	législati
légistes 	légistes 
légitime 	légitime 
légère 	légère
légèrement 	légère
lié 	lié 
liaison 	liaison 
liant 	liant 
liban 	liban
libanais 	libanais
libanaise 	libanais
libanaises 	libanais
libbi 	libbi 
libby 	libby 
liberia 	liber
liberté 	liber
libéré 	libér
librairie 	librairie 
libéral 	libér
libérale 	libér
libérateur 	libér
libération 	libér
libéraux 	libér
libérée 	libér
libérée 	libér
libre 	libre 
libre 	libre 
librement 	librement 
libérer 	libér
libres 	libres 
libérez 	libér
libéria 	libér
libérienne 	libér
libérés 	libér
libye 	libye
libyen 	libye
libyenne 	libyenne
libyennes 	libyenne
libyens 	libye
licencie 	licencie
licenciement 	licencie
licorne 	licorne 
liée 	liée 
lien 	lien 
liens 	liens 
lier 	lier 
liées 	liées 
lieu 	lieu 
lieutenant 	lieutenant
lieutenants 	lieutenant
lieux 	lieux 
ligne 	ligne
lignes 	ligne
likoud 	likoud 
limbourg 	limbourg 
éliminations 	élimin
éliminer 	élimin
limitant 	limit
limitation 	limit
limite 	limit
limiter 	limit
limites 	limit
limités 	limit
linguistique 	linguistique
linguistiques 	linguistique
lionceau 	lionceau 
liquidations 	liquidations 
liran 	liran 
élire 	élire 
élire 	élire 
lire 	lire 
lire 	lire 
liés 	liés 
élisaient 	élis
élisent 	élis
liste 	liste
listes 	liste
élit 	élit 
lituanien 	litu
liturgie 	litu
live 	live 
livingstone 	livingstone 
livré 	livré 
livraisons 	livraisons 
livre 	livre 
livrer 	livrer 
livrées 	livrées 
livres 	livres 
livrés 	livrés 
ll 	ll 
éléments 	éléments 
lobbyiste 	lobbyiste 
local 	loca
locale 	loca
locales 	loca
localisé 	loca
localité 	localité
localités 	localité
locaux 	loca
loi 	loi 
éloignée 	éloign
éloigne 	éloign
éloigner 	éloign
éloignés 	éloign
loin 	loin 
lois 	lois 
lomé 	lomé 
londonien 	londonien
londonienne 	londonien
londoniens 	londonien
londonistan 	londoni
àlondres 	àlondres 
àlondres 	àlondres 
àlondres 	àlondres 
àlondres 	àlondres 
londres 	lond
londres 	lond
londres 	lond
londres 	lond
londres 	lond
long 	long
longtemps 	long
longue 	long
longues 	long
lord 	lord 
lords 	lords 
lors 	lors 
lorsqu 	lorsqu
lorsque 	lorsqu
los 	los 
lot 	lot 
loteries 	loteries 
loti 	loti 
louisiane 	louisiane 
lourd 	lourd
lourde 	lourd
lourdement 	lourd
lousiane 	lousiane 
louxor 	louxor 
lésion 	lésion 
létale 	létale 
léthale 	léthale 
élu 	élu 
élu 	élu 
lu 	lu 
lu 	lu 
luc 	luc 
lucide 	lucide 
lucio 	lucio 
élue 	élue 
élue 	élue 
lue 	lue 
lue 	lue 
lui 	lui 
lumières 	lumières 
lunatique 	lunatique 
lundi 	lundi 
luranium 	luranium 
élus 	élus 
lusaka 	lusaka 
luton 	luton 
luttaient 	luttaient 
luttant 	luttant 
lutte 	lutte 
luttent 	luttent 
lutter 	lutter 
luxembourg 	luxembourg
luxembourgeois 	luxembourgeois
luxembourgeoise 	luxembourgeois
élève 	élève
lève 	lève 
élèvent 	élève
élèverait 	élève
élèves 	élève
lycée 	lycée
lycéenne 	lycée
lyncher 	lyncher 
lynndie 	lynndie 
lyon 	lyon 
m 	m 
ma 	ma 
maaouiya 	maaou
maaouyia 	maaou
macaulay 	macaulay 
macshane 	macshane 
madaïen 	madaïen 
madonna 	madonna 
madrid 	madrid 
mafia 	mafia 
magasin 	magasin
magasins 	magasin
magazine 	magazine 
magdi 	magdi 
magistrat 	magistrat
magistrats 	magistrat
magnat 	magnat 
magnitude 	magnitude 
magouilles 	magouilles 
mahdi 	mahdi 
mahmoud 	mahmoud 
mahomet 	mahomet 
mai 	mai 
émaillées 	émaillées 
main 	main
maine 	main
mainmise 	main
mains 	main
maintenait 	main
maintenant 	main
maintenir 	main
maintenu 	main
maintenue 	main
maintien 	main
maintiendra 	main
maintient 	main
maire 	mair
mairie 	mair
mais 	mais
maison 	maison
maisons 	maison
majesté 	majesté 
majeur 	majeur
majeure 	majeur
major 	major
majorité 	majorit
majoritairement 	majorit
makalu 	makalu 
mal 	mal 
malade 	malade 
maladie 	maladie
maladies 	maladie
malaise 	malaise 
malbrunot 	malbrunot 
malfaiteurs 	malfaiteurs 
malformations 	malformations 
malgré 	malgré 
malheureusement 	malheureu
malheureux 	malheureu
mali 	mali 
malsain 	malsain 
malveillance 	malve
malvenus 	malve
maman 	maman 
mamma 	mamma 
man 	man 
manche 	manch
manchots 	manch
émancipe 	émancipe 
mandalan 	manda
mandat 	manda
mandats 	manda
mangé 	mangé 
manifesté 	mani
manifestaient 	mani
manifestants 	mani
manifestation 	mani
manifestations 	mani
manifestent 	mani
manifester 	mani
manille 	mani
manipulation 	mani
manière 	mani
manoeuvre 	manoeuvre
manoeuvres 	manoeuvre
manque 	manqu
manquement 	manquement
manquements 	manquement
manquent 	manqu
manqués 	manqu
manuel 	manuel
manuels 	manuel
maquette 	maquette 
mar 	mar 
maracaibo 	maracaibo 
maraîcher 	maraîcher 
maradona 	maradona 
maraicabo 	maraicabo 
marathon 	marathon 
marécage 	marécage 
marché 	marché 
marchandages 	marchandages 
marche 	marche 
marchent 	marchent 
marcinkiewicz 	marcinkiewicz 
mardi 	mardi
mardion 	mardi
marée 	marée 
margaret 	margaret
margareth 	margaret
marge 	marge 
marginalisés 	marginalisés 
margo 	margo 
mari 	mari 
mari 	mari 
marié 	marié 
marié 	marié 
maria 	maria 
mariage 	mariage
mariages 	mariage
marienfeld 	marienfeld 
marier 	marier 
marin 	marin 
marine 	marine 
marines 	marines 
mariniers 	mariniers 
marins 	marins 
mario 	mario 
mariés 	mariés 
maritime 	maritime 
mark 	mark 
marketing 	marketing 
maroc 	maroc
marocain 	marocain
marocaine 	marocain
marocains 	marocain
maroco 	maroc
marqué 	marqu
marquaient 	marqu
marquant 	marqu
marquée 	marqu
marque 	marqu
marquer 	marqu
marquera 	marqu
marquées 	marqu
marriott 	marriott 
mars 	mars 
marshall 	marshall 
martin 	martin
martiniquais 	martiniquais
martiniquaises 	martiniquais
martinique 	martiniqu
martèle 	martèle 
marty 	marty 
martyrs 	martyrs 
maskhadov 	maskhadov 
masque 	masque 
masri 	masri 
massacre 	massacre
massacres 	massacre
masse 	masse 
massif 	massif 
massive 	massive
massivement 	massive
massives 	massive
masturbait 	masturb
masturber 	masturb
matées 	matées 
mathématiquement 	mathématiquement 
matin 	matin 
matinée 	matinée 
matière 	matière 
maître 	maîtr
maîtrisé 	maîtr
matsa 	matsa 
mauff 	mauff 
maumousseau 	maumousseau 
mauritanie 	mauritanie 
mausolée 	mausolée 
mauvais 	mauvais
mauvaise 	mauvais
mauvaises 	mauvais
maximal 	maximal
maximale 	maximal
maximum 	maxim
mayer 	mayer 
mécanique 	mécanique 
mcclellan 	mcclellan 
méconnaissable 	méconn
méconnu 	méconn
md 	md 
médecin 	médecin
médecins 	médecin
média 	média 
médias 	médias 
médiation 	médiati
médiatique 	médiati
médical 	médica
médicalement 	médica
médicales 	médica
médicaux 	médica
médiocre 	médiocre 
méditerranée 	méditerranée 
me 	me 
mea 	mea 
mecque 	mecque 
meeting 	meeting
meetings 	meeting
mehlis 	mehlis 
mehmet 	mehmet 
meiwes 	meiwes 
melbourne 	melbourne 
melchemie 	melche
melchers 	melche
melilla 	melilla 
melinda 	melinda 
melville 	melville 
membre 	membre
membres 	membre
mené 	mené 
menaçaient 	menaça
menaçait 	menaça
menaçant 	menaçant
menaçants 	menaçant
menacé 	menacé 
menacée 	menacée 
menacée 	menacée 
menacée 	menacée 
menacée 	menacée 
menace 	menace 
menace 	menace 
menace 	menace 
menace 	menace 
menace 	menace 
menacent 	menacent 
menacer 	menacer 
menacées 	menacées 
menacées 	menacées 
menacées 	menacées 
menacées 	menacées 
menacées 	menacées 
menacées 	menacées 
menacées 	menacées 
menaces 	menaces 
menaces 	menaces 
menaces 	menaces 
menaces 	menaces 
menaces 	menaces 
menaces 	menaces 
menaces 	menaces 
menacés 	menacés 
menée 	menée 
menendes 	menendes 
mener 	mener 
menet 	menet 
meneur 	meneur 
menezes 	menezes 
menottée 	menottée 
mentale 	mentale 
mentent 	mentent 
menteuse 	menteuse 
menti 	menti 
mentionné 	mentionn
mentionner 	mentionn
mentir 	mentir 
menu 	menu 
mer 	mer 
merci 	merc
mercredi 	merc
émergents 	émergents 
merkel 	merkel 
me saadoun 	me saadoun 
message 	message
messages 	message
messe 	messe 
messes 	messes 
mesurée 	mesur
mesure 	mesur
mesure 	mesur
mesurer 	mesur
mesures 	mesur
mesurés 	mesur
met 	met 
metro 	metro 
mettaient 	mettaient 
mettait 	mettait 
mettant 	mettant 
mettent 	mettent 
mettre 	mettre 
meurt 	meurt
meurtre 	meurt
meurtres 	meurt
meurtrie 	meurt
meurtrier 	meurt
meurtriers 	meurt
meurtrière 	meurtrière
meurtrières 	meurtrière
émeute 	émeute
émeutes 	émeute
mexicaine 	mexicain
mexicains 	mexicain
mexique 	mexi
méfiance 	méfiance 
mégapole 	mégapole 
mgr 	mgr 
mi 	mi 
mi5 	mi5 
mi6 	mi6 
miami 	miami 
michael 	mich
michalowski 	mich
michel 	michel
michelin 	michel
michelle 	michel
michelle bachelet 	michel
midi 	midi 
miers 	miers 
mieux 	mieux 
émigrants 	émigrants 
migrants 	migrants 
émigration 	émigration 
émigrés 	émigrés 
mikhaïl 	mikhaïl 
milan 	milan 
milices 	mili
miliciens 	mili
milieu 	mili
milieux 	mili
militaire 	mili
militaires 	mili
militant 	mili
militants 	mili
milliard 	milliard
milliardaire 	milliard
milliards 	milliard
millier 	mill
milliers 	mill
millième 	mill
million 	mill
millions 	mill
millénaire 	mill
mills 	mill
miné 	miné 
mina 	mina 
minant 	minant 
mine 	mine 
éminence 	éminence 
minerait 	minerait 
mines 	mines 
mineur 	mineur
mineure 	mineur
mineurs 	mineur
mini 	mini 
minibus 	minibus 
minimisant 	minimis
minimiser 	minimis
minimum 	minimum 
ministère 	minist
ministère 	minist
ministère 	minist
ministère 	minist
ministère 	minist
ministère 	minist
ministère 	minist
ministère 	minist
ministère 	minist
ministère 	minist
ministère 	minist
ministère 	minist
ministère 	minist
ministère 	minist
ministre 	minist
ministre 	minist
ministre 	minist
ministre 	minist
ministre 	minist
ministre 	minist
ministre 	minist
ministre 	minist
ministre 	minist
ministre 	minist
ministre 	minist
ministre 	minist
ministre 	minist
ministre 	minist
ministre 	minist
ministre jean 	minist
ministères 	minist
ministères 	minist
ministres 	minist
ministres 	minist
ministérielle 	minist
minnesota 	minnesota 
minorité 	minorit
minoritaire 	minoritaire
minoritaires 	minoritaire
minuit 	minuit 
minute 	minute
minutes 	minute
miqati 	miqati 
miracle 	miracle
miracles 	miracle
miraculés 	mirac
mire 	mire 
mirror 	mirror 
émis 	émis 
mis 	mis 
mis 	mis 
mise 	mise 
misère 	misère 
missile 	missi
émission 	émission 
émission 	émission 
émission 	émission 
émission 	émission 
mission 	missi
mission 	missi
mission 	missi
mission 	missi
émissions 	émissions 
missions 	missi
mississippi 	missi
mister 	mister 
mitigée 	mitigée 
mitraillé 	mitraillé 
mixtes 	mixtes 
mladic 	mladic 
mélange 	mélan
mélanie 	mélan
mêler 	mêler 
même 	même
mêmes 	même
mémoire 	mémoire
mémoires 	mémoire
ménagé 	ména
ménage 	ména
ménages 	ména
ménard 	ména
mène 	mène
mènent 	mène
mènera 	mène
mènerait 	mène
münster 	münster 
müntefering 	müntefering 
mobile 	mobil
mobiles 	mobil
mobilisé 	mobilis
mobilisait 	mobilis
mobilisation 	mobilis
mobilisée 	mobilis
mobilisée 	mobilis
mobilisée 	mobilis
mobilise 	mobilis
mobilise 	mobilis
mobilisent 	mobilis
mobiliser 	mobilis
mobilisés 	mobilis
modalités 	modalités 
mode 	mode 
moderne 	modern
modernes 	modern
modernisation 	modernis
moderniser 	modernis
modes 	modes 
modeste 	modeste 
modifiée 	modifi
modifier 	modifi
modèle 	modèle
modèles 	modèle
modéré 	modér
modération 	modér
modérés 	modér
mohamed 	moham
mohammed 	moham
émoi 	émoi 
moi 	moi 
moindre 	moin
moine 	moin
moins 	moin
mois 	mois 
moitié 	moitié 
moléculaire 	moléculaire 
mollesse 	mollesse 
moment 	moment
moments 	moment
mon 	mon 
monaco 	monaco 
monarque 	monarque 
monastère 	monastère 
monde 	monde 
mondial 	mondial
mondiale 	mondial
mondiales 	mondial
mondialisation 	mondial
moneda 	moneda 
monégasque 	monégasque
monégasques 	monégasque
mongolie 	mongolie 
monica 	monica 
monique 	monique 
monnayées 	monnayées 
monney 	monney 
monoxyde 	monoxyde 
monstre 	monstre 
montagne 	montagne
montagnes 	montagne
montée 	montée 
monter 	monter 
montré 	montré 
montréal 	montréal 
montrant 	montrant 
montrée 	montrée 
montrée 	montrée 
montre 	montre 
montre 	montre 
montre 	montre 
montrent 	montrent 
montrer 	montrer 
montrées 	montrées 
moque 	moque 
moral 	moral
morales 	moral
morceler 	morceler 
morgues 	morgues 
moribonde 	moribonde 
mort 	mort 
morte 	morte 
mortel 	mortel 
mortellemet 	mortellemet 
mortes 	mortes 
mortier 	mortier 
morts 	morts 
mortuaires 	mortuaires 
moscou 	moscou 
moshé 	moshé 
mosquée 	mosquée
mosquées 	mosquée
mossad 	mossad 
mossoul 	mossoul 
mot 	mot 
motassadeq 	motassadeq 
moteur 	moteur
moteurs 	moteur
motif 	motif 
émotion 	émotion 
motion 	motion 
motion 	motion 
motivations 	motivations 
motorisation 	motorisation 
moubarak 	moubarak 
mouillée 	mouillée 
mounir 	mounir 
mourir 	mourir 
moussa 	mouss
moussab 	mouss
moussaoui 	mouss
moussayeb 	mouss
mousson 	mouss
mouvance 	mouvance 
mouvement 	mouvement
mouvement 	mouvement
mouvement 	mouvement
mouvementé 	mouvement
mouvementé 	mouvement
mouvements 	mouvement
moyen 	moyen
moyens 	moyen
méprise 	méprise 
mr 	mr 
mère 	mère
mères 	mère
méridionale 	méri
mérite 	méri
msf 	msf 
méthode 	méthode 
métier 	métier 
météo 	météo
météorologiques 	météorolog
météorologues 	météorolog
mètres 	mètres 
métro 	métro
métropole 	métro
métros 	métro
muet 	muet 
mulltiplient 	mulltiplient 
multiculturalisme 	multi
multinationales 	multi
multiples 	multi
multiplié 	multi
multipliaient 	multi
multiplication 	multi
multiplie 	multi
multiplient 	multi
multipliées 	multi
munich 	muni
municipales 	municipa
municipalités 	municipa
municipaux 	municipa
munitions 	muni
mur 	mur 
murr 	murr 
émus 	émus 
musée 	musée 
musharraf 	musharraf 
musicale 	musicale 
mussolini 	mussolini 
musulman 	musulman
musulmane 	musulman
musulmanes 	musulman
musulmans 	musulman
mutilé 	mutilé 
mutile 	mutile 
mutinerie 	mutinerie 
mutuellement 	mutuellement 
muzaffarabad 	muzaffarabad 
mystère 	myst
mystérieux 	myst
mythe 	myth
mythique 	myth
mézières 	mézières 
n 	n 
n°1 	n°1 
n°2 	n°2 
n°3 	n°3 
nabi 	nabi 
nachar 	nachar 
nacional 	nacional 
naftogaz 	naftogaz 
nagasaki 	nagasaki 
nagin 	nagin 
nairobi 	nairobi 
naissance 	naissance 
naltchik 	naltchik 
namur 	namur 
néanmoins 	néanmoins 
naples 	naples 
napolitaine 	napolitaine 
nast 	nast 
natal 	natal 
natale 	natale 
natanz 	natanz 
nation 	nation
national 	nation
nationale 	nation
nationales 	nation
nationaliste 	nation
nationalité 	nation
nationaux 	nation
nations 	nation
nativité 	nativité 
naturaliste 	natur
nature 	natur
naturelle 	natur
naufragé 	naufrag
naufrage 	naufrag
navarro 	navarro 
navire 	navire
navires 	navire
nazie 	nazi
nazis 	nazi
nazisme 	nazi
nébuleuse 	nébuleuse 
nécessaire 	nécessaire
nécessaires 	nécessaire
nécessité 	nécess
âne 	âne 
âne 	âne 
âne 	âne 
née 	née 
née 	née 
ne 	ne 
ne 	ne 
ne 	ne 
ne 	ne 
nee 	nee 
neenus 	neenus 
neige 	neige 
neil 	neil 
énergie 	énerg
énergétique 	énerg
néerlandais 	néerlandais
néerlandaise 	néerlandais
néerlandaises 	néerlandais
néerlandophone 	néerland
net 	net 
netanya 	netanya
netanyahu 	netanya
nette 	nette
nettement 	nette
neuchâtel 	neuchâtel 
neuf 	neuf 
neve 	neve
neverland 	neve
new 	new 
news 	news 
newsweek 	newsweek 
négative 	négative 
négocié 	négoci
négociable 	négoci
négociateurs 	négoci
négociations 	négoci
négocie 	négoci
négocier 	négoci
négociées 	négoci
ni 	ni 
ni 	ni 
nié 	nié 
nié 	nié 
nié 	nié 
niant 	niant 
nias 	nias 
niche 	niche 
nicola 	nicola
nicolas 	nicola
nid 	nid 
nie 	nie 
nies 	nies 
niet 	niet 
niger 	niger
nigeria 	niger
nigérian 	nigéri
nigérien 	nigéri
nippon 	nippon
nippone 	nippon
nippones 	nippon
niveau 	niveau
niveaux 	niveau
nixon 	nixon 
néo 	néo 
no 	no 
no 	no 
nobel 	nobel 
noie 	noie 
noir 	noir 
noire 	noire 
noires 	noires 
noirs 	noirs 
noël 	noël 
nom 	nom 
nombre 	nombre
nombreuses 	nombre
nombreux 	nombre
nominé 	nomin
nomination 	nomination
nominations 	nomination
nommé 	nommé 
nommant 	nommant 
nommément 	nommément 
noms 	noms 
non 	non 
nord 	nord 
normal 	normal
normale 	normal
normalement 	normal
énormes 	énormes 
énormes 	énormes 
normes 	normes 
norvégien 	norvégien
norvégiens 	norvégien
nos 	nos 
notamment 	notamment 
note 	note 
notre 	notre 
notting 	notting 
nouakchott 	nouakchott 
nouaïmi 	nouaïmi 
nour 	nour 
nourri 	nourri
nourris 	nourri
nourriture 	nourri
nous 	nous 
nouveau 	nouveau
nouveaux 	nouveau
nouvel 	nouve
nouvelle 	nouvelle
nouvellement 	nouvelle
nouvelles 	nouvelle
novembre 	novembre 
novice 	novice 
noyé 	noyé
noyée 	noyé
noyées 	noyé
népal 	népal
népalais 	népalais
népalaise 	népalais
nétait 	nétait 
nuage 	nuage 
nucléaire 	nucléaire
nucléaires 	nucléaire
nuit 	nuit 
nulle 	nulle
nullement 	nulle
énumère 	énumère 
numéro 	numéro
numéros 	numéro
nus 	nus 
ny 	ny 
o 	o 
o 	o 
où 	où 
où 	où 
où 	où 
obéi 	obéi 
objectif 	objectif
objectifs 	objectif
objet 	obje
objets 	obje
obligatoire 	oblig
oblige 	oblig
obligeant 	oblig
obligés 	oblig
obscènes 	obscènes 
obscur 	obscur 
observé 	observ
observateur 	observ
observateurs 	observ
observée 	observ
observer 	observ
observées 	observ
obsèques 	obsèques 
obstacles 	obstacles 
obtenant 	obten
obtenir 	obten
obtention 	obten
obtenu 	obten
obtenue 	obten
obtiendraient 	obtien
obtiendrait 	obtien
obtiennent 	obtien
obtient 	obtien
ocalan 	ocalan 
océan 	océan 
occasion 	occasion
occasions 	occasion
occident 	occident
occidentales 	occident
occidentaux 	occident
occupé 	occup
occupaient 	occup
occupait 	occup
occupant 	occup
occupants 	occup
occupation 	occup
occupée 	occup
occupe 	occup
occupent 	occup
occuper 	occup
occupées 	occup
octobre 	octobre 
oecuménisme 	oecuménisme 
oeil 	oeil
oeillets 	oeil
oeuvre 	oeuvre 
of 	of 
off 	off 
offenser 	offens
offensive 	offens
offert 	offert 
offices 	offic
officialisé 	offic
officiel 	officiel
officielle 	officielle
officiellement 	officielle
officielles 	officielle
officiels 	officiel
offrandes 	offrandes 
offre 	offre 
offres 	offres 
offrir 	offrir 
offshore 	offshore 
oiseau 	oiseau 
olivier 	olivier 
olmert 	olmert 
olympio 	olympi
olympique 	olympique
olympiques 	olympique
omar 	omar 
ombre 	ombre
ombres 	ombre
omet 	omet 
on 	on 
onction 	onction 
ondimba 	ondimba 
ong 	ong 
ont 	ont 
onu 	onu 
onusien 	onusien 
onze 	onze 
ophelia 	ophelia 
opinion 	opinion 
opportunité 	opportunité 
opposé 	opposé 
opposant 	opposant
opposants 	opposant
opposée 	opposée 
oppose 	oppose 
oppose 	oppose 
opposent 	opposent 
opposer 	opposer 
opposition 	opposition 
opposés 	opposés 
opprimés 	opprimés 
opéré 	opér
opéra 	opér
opérant 	opér
opérateurs 	opér
opération 	opération
opérationnels 	opération
opérations 	opération
optimiste 	opti
option 	opti
optiques 	opti
or 	or 
orages 	orages 
orange 	orange 
oraux 	oraux 
orbi 	orbi 
orchestrées 	orchestrées 
ordinaires 	ordinaires 
ordonné 	ordonn
ordonnée 	ordonn
ordonner 	ordonn
ordre 	ordre
ordres 	ordre
ore 	ore 
oreilles 	oreilles 
ores 	ores 
organisé 	organis
organisateur 	organisat
organisateurs 	organisat
organisation 	organisat
organisations 	organisat
organisatrice 	organisat
organisée 	organis
organisée 	organis
organise 	organis
organise 	organis
organise 	organis
organisent 	organis
organiser 	organis
organisera 	organis
organisées 	organis
orient 	orient
orientale 	orient
origine 	origine 
orléans 	orléans 
orly 	orly 
ormouz 	ormouz 
ormuz 	ormuz 
orsay 	orsay 
osce 	osce 
oscillent 	oscillent 
osée 	osée 
ose 	ose 
osservatore 	osservatore 
ossétie 	ossétie 
otage 	otage
otages 	otage
otan 	otan 
otis 	otis 
ou 	ou 
ouathi 	ouathi 
oublié 	oubli
oublie 	oubli
ouest 	ouest 
oui 	oui 
ould 	ould 
ouragan 	ouragan
ouragan katrina 	ouragan
oussama 	oussama 
outils 	outils 
outre 	outre 
ouvert 	ouvert
ouverte 	ouvert
ouvertement 	ouvert
ouvertes 	ouvert
ouverts 	ouvert
ouverture 	ouvert
ouvrage 	ouvrage 
ouvrant 	ouvrant 
ouvre 	ouvre 
ouvrent 	ouvrent 
ouvriers 	ouvriers 
ouvrir 	ouvrir 
ouzbekistan 	ouzb
ouzbèke 	ouzb
ouzbékistan 	ouzb
oval 	oval 
over 	over 
oxygène 	oxygène 
pac 	pac 
pacifique 	pacifique
pacifiquement 	pacifique
pacifiste 	pacifiste
pacifistes 	pacifiste
pacs 	pacs 
pacte 	pacte 
pactole 	pactole 
pagaille 	pagaille 
péage 	péage 
page 	page 
pages 	pages 
paille 	paille 
épais 	épais 
paix 	paix 
pakistan 	pakistan
pakistanais 	pakistanais
pakistanaise 	pakistanais
pakistanaises 	pakistanais
palacio 	palacio 
palais 	palais 
palatine 	palatine 
palerme 	palerme 
palestine 	palestin
palestinien 	palestinien
palestinienne 	palestinien
palestiniennes 	palestinien
palestiniens 	palestinien
palier 	palier 
panabaj 	panabaj 
panama 	panama 
pancréatite 	pancréatite 
pandémies 	pandémies 
panique 	panique 
panne 	panne
pannes 	panne
panse 	panse 
pantalon 	pantalon 
paolo 	paolo 
papabili 	papabili 
papale 	papale 
papauté 	papauté 
pape 	pape 
papouasie 	papouasie 
paquet 	paquet 
paradis 	paradis 
paraissait 	paraissait 
parallèlement 	parallèl
parallèllement 	parallèl
paralysé 	paralys
paralysait 	paralys
paralysie 	paralys
paralysés 	paralys
paramilitaires 	paramilitaires 
paramètres 	paramètres 
parce 	parce 
parcourant 	parcour
parcours 	parcour
parcouru 	parcour
pardon 	pardon 
parents 	parents 
parfait 	parfait 
parfois 	parfois 
parfum 	parfum
parfums 	parfum
épargné 	épargn
épargne 	épargn
épargner 	épargn
épargnées 	épargn
pari 	pari 
parie 	parie 
paris 	paris 
parisien 	parisien 
paritaire 	paritaire 
park 	park 
parker 	parker 
parks 	parks 
parlé 	parlé 
parla 	parla 
parlant 	parlant 
parle 	parle 
parlement 	parlement
parlementaire 	parlementaire
parlementaires 	parlementaire
parlent 	parlent 
parler 	parler 
parmi 	parmi 
parodie 	parodie 
parole 	parole 
parquet 	parquet 
parrainé 	parrainé 
part 	part 
partagée 	partagée 
partage 	partage 
partageront 	partageront 
partagés 	partagés 
partait 	partait 
partant 	partant 
partenaire 	partenaire
partenaires 	partenaire
partenariat 	partenariat
partenariats 	partenariat
partent 	parten
parti 	parti 
participé 	particip
participaient 	particip
participant 	particip
participants 	particip
participation 	particip
participe 	particip
participer 	particip
particulier 	particuli
particulière 	particulière
particulièrement 	particulière
partie 	partie 
partiel 	partiel 
partielle 	partielle
partiellement 	partielle
partiels 	partiels 
parties 	parties 
partir 	partir 
partis 	partis 
partisans 	partisans 
partitions 	partitions 
partout 	partout 
parus 	parus 
parvenir 	parven
parvenu 	parven
parvenus 	parven
parviendra 	parvien
parviennent 	parvien
parvis 	parvis 
passé 	passé 
passage 	passage 
passager 	passager 
passagers 	passagers 
passagère 	passagère 
passant 	passant
passants 	passant
passation 	passation 
passée 	passée 
passée 	passée 
passe 	passe 
passe 	passe 
passeport 	passeport
passeports 	passeport
passer 	passer 
passion 	passion
passionné 	passion
passés 	passés 
pasteur 	pasteur 
pat 	pat 
pathétique 	pathétique 
patiente 	patiente 
patinoire 	patinoire 
patriarche 	patriarche 
patrice 	patrice 
patrick 	patrick 
patrimoine 	patrimoine 
patriotisme 	patriotisme 
patron 	patron 
patronat 	patronat 
patrons 	patrons 
patrouiller 	patrouille
patrouilles 	patrouille
paul 	paul 
épaule 	épaule 
pause 	pause 
pauvre 	pauvre
pauvres 	pauvre
pauvreté 	pauvre
payer 	payer 
payées 	payées 
pays 	pays 
pêcher 	pêche
pêcheurs 	pêche
pédagogiques 	pédagogiques 
pdg 	pdg 
pédophiles 	pédophil
pédophilie 	pédophil
peace 	peace 
peau 	peau 
peiné 	pein
peine 	pein
peinent 	pein
penche 	penche
pencher 	penche
pendant 	pendant 
penn 	penn 
pensaient 	pensaient 
pense 	pense 
pensent 	pensent 
penser 	penser 
pension 	pension 
pensés 	pensés 
pentagone 	pentagone 
perben 	perben 
percée 	percée 
percement 	percement 
perception 	perception 
percevez 	percevez 
percutée 	percutée 
perdant 	perdant 
perdent 	perdent 
perdu 	perdu 
perdue 	perdue 
peres 	peres 
performance 	performance 
perfusion 	perfusion 
permanence 	permanen
permanente 	permanen
permanents 	permanen
permet 	permet
permettant 	permet
permettrait 	permet
permettre 	permet
permis 	permis 
perçoivent 	perçoivent 
perpétré 	perpétré
perpétrée 	perpétré
perpétrées 	perpétré
perpétré mercredi 	perpétré
perpétrés 	perpétré
perpétuité 	perpét
perquisition 	perquisition
perquisitionnés 	perquisition
perquisitions 	perquisition
persisté 	persist
persistantes 	persist
personnage 	personn
personnalité 	personnalité
personnalités 	personnalité
personne 	personn
personnelle 	personn
personnels 	personn
personnes 	personn
perspective 	perspective 
persuadée 	persuadée 
pertes 	pertes 
perturbations 	perturb
perturber 	perturb
perçus 	perçus 
pesaient 	pesaient 
pessimiste 	pessimiste
pessimistes 	pessimiste
petit 	petit
petite 	petit
petits 	petit
petropavlovsk 	petropavlovsk 
peu 	peu 
peuple 	peuple
peuples 	peuple
peur 	peur 
peut 	peut 
peuvent 	peuvent 
pharmacies 	pharmacies 
phase 	phase 
philadelphie 	phil
philippe 	philipp
philippin 	philippin
philippines 	philippin
philippins 	philippin
phénomène 	phénomène 
photo 	photo
photographies 	photo
photos 	photo
physiques 	physiques 
piano 	piano 
pib 	pib 
pièces 	pièces 
épidémie 	épidémie 
pierre 	pierre 
piégé 	piégé 
piégée 	piégée 
piégée 	piégée 
piégée 	piégée 
piège 	piège 
piège 	piège 
piégées 	piégées 
pilier 	pilier 
pillages 	pillages 
pillards 	pillards 
pillée 	pillée 
épilogue 	épilogue 
pilote 	pilote
pilotes 	pilote
pilule 	pilule 
pinault 	pinault 
pinera 	pinera 
épinglé 	épingl
épingle 	épingl
pinochet 	pinochet 
pionnière 	pionnière 
pire 	pire
pires 	pire
épisode 	épisode 
piste 	piste 
épithètes 	épithètes 
pitoyable 	pitoyable 
pékin 	pékin 
pkk 	pkk 
placé 	placé 
placard 	placard 
placée 	placée 
place 	place 
place 	place 
placent 	placent 
placer 	placer 
placées 	placées 
placés 	placés 
plage 	plage 
plages 	plages 
plagiat 	plagiat 
plaidé 	plaidé 
plaidant 	plaidant 
plaide 	plaide 
plaider 	plaider 
plaidoiries 	plaidoiries 
plaies 	plaies 
plaignants 	plaignants 
plain 	plain 
plainte 	plainte
plaintes 	plainte
plame 	plame
plamegate 	plame
plan 	plan 
planche 	planche 
plane 	plane 
planer 	planer 
plans 	plans 
planétaire 	planétaire
planétaires 	planétaire
planète 	planète 
planteurs 	planteurs 
plantu 	plantu 
plaques 	plaques 
plaît 	plaît 
plata 	plata 
plateaux 	plateaux 
plateforme 	plateforme 
plausible 	plausible 
plébiscite 	plébiscite
plébiscitent 	plébiscite
plein 	plein
pleine 	plein
pleins 	plein
pèlerinage 	pèlerin
pèlerins 	pèlerin
pleure 	pleure 
plié 	plié 
plongé 	plong
plongée 	plong
plongeant 	plong
pluie 	pluie
pluies 	pluie
plupart 	plupart 
plusieurs 	plusieurs 
plutôt 	plutôt 
pénal 	pénal 
péninsule 	péninsule 
pénitentiaire 	pénitentiaire 
pénétré 	pénétr
pénètrent 	pénètrent 
pénétrer 	pénétr
pénurie 	pénurie
pénuries 	pénurie
poids 	poids 
poignardé 	poignardé
poignardée 	poignardé
poignée 	poign
poil 	poil 
point 	point
pointée 	point
pointe 	point
pointent 	point
points 	point
poison 	poison 
polaire 	polaire 
polanski 	polanski 
police 	police 
polices 	polices 
policier 	policier
policiers 	policier
politicienne 	politicien
politiciens 	politicien
politico 	politi
politique 	politique
politiques 	politique
polluées 	pollu
pollution 	pollu
polémique 	polémique
polémiques 	polémique
pologne 	pologne 
polonais 	polonais 
polyclinique 	polyclinique 
polygamie 	polygamie 
pom 	pom 
pompage 	pompage 
pompes 	pompes 
pompiers 	pompiers 
pomppedda 	pomppedda 
poncet 	ponc
ponctionner 	ponc
éponge 	éponge 
pont 	pont
ponte 	pont
pontife 	pont
pontificat 	pont
ponts 	pont
pop 	pop 
popstar 	popstar 
populaire 	popula
populaires 	popula
popularité 	popula
population 	popula
populations 	popula
époque 	époque 
pornographique 	pornographique 
port 	port 
port 	port 
port 	port 
port 	port 
porté 	porté 
porté 	porté 
porté 	porté 
portable 	portable 
portait 	portait 
portant 	portant
portant la 	portant
porte 	porte 
portent 	portent 
porter 	porter 
portées 	portées 
portrait 	portrait
portraits 	portrait
portés 	portés 
ports 	ports 
portsmouth 	portsmouth 
portugais 	portuga
portugal 	portuga
posé 	posé 
pose 	pose 
posent 	posent 
poser 	poser 
poseur 	poseur
poseurs 	poseur
posez 	posez 
positif 	positi
positifs 	positi
position 	positi
positions 	positi
positive 	positi
possède 	possède 
possibilité 	possibilité
possibilités 	possibilité
possible 	possible
possibles 	possible
post 	post 
poste 	poste 
posten 	posten 
posthume 	posthume 
postulent 	postulent 
potentiel 	potentiel
potentiellement 	potentiel
potentielles 	potentiel
potentiels 	potentiel
pots 	pots 
poubelle 	poubelle 
poumon 	poumon 
pourparlers 	pourparlers 
pourquoi 	pourquoi 
pourra 	pourra 
pourraient 	pourraient 
pourrait 	pourrait 
pourront 	pourront 
poursuit 	poursui
poursuite 	poursui
poursuites 	poursui
poursuivait 	poursui
poursuivent 	poursui
poursuivi 	poursui
poursuivra 	poursui
poursuivre 	poursui
pourtant 	pourtant 
épouse 	épouse 
poussé 	poussé 
poussée 	poussée 
pousser 	pousser 
poussière 	poussière 
pousuivent 	pousuivent 
poutine 	poutine 
pouvez 	pouvez 
pouvoir 	pouvoir
pouvoirs 	pouvoir
époux 	époux 
power 	power 
pâques 	pâques 
pré 	pré 
pradesh 	pradesh 
pragmatiques 	pragmatiques 
préalable 	préalable
préalables 	préalable
pratique 	pratique
pratiquement 	pratique
précédent 	précédent
précédente 	précédent
précédentes 	précédent
précédents 	précédent
prêche 	prêche 
précipitamment 	précipita
précipitations 	précipita
précis 	préci
précisé 	préci
précise 	préci
précisent 	préci
précises 	préci
précisément 	préci
prédateur 	préd
prédécesseur 	préd
prédécesseurs 	préd
prédestiné 	préd
prédicateurs 	préd
prédication 	préd
prédominent 	préd
père 	père 
 premier 	 premier 
premier 	premier 
premier 	premier 
premiers 	premiers 
première 	première
premières 	première
prenaient 	pren
prenait 	pren
prenant 	pren
éprend 	éprend 
prend 	pren
prend 	pren
prendra 	prendr
prendre 	prendr
preneur 	preneur
preneurs 	preneur
pérenne 	pérenne 
âpres 	âpres 
pères 	pères 
pères 	pères 
presque 	pres
press 	pres
pressant 	pres
pressantes 	pres
presse 	pres
pression 	pres
pressions 	pres
pressurisé 	pres
pressurisation 	pres
prestations 	pres
prestige 	pres
preuve 	preuve
preuves 	preuve
préfet 	préf
préférer 	préf
péri 	péri
prié 	prié 
priée 	priée 
prient 	prient 
prier 	prier 
priées 	priées 
péril 	péri
primaire 	primaire
primaires 	primaire
prime 	prime 
primes 	primes 
primordiale 	primordiale 
prince 	prince 
prince rainier 	prince rainier 
princesse 	princesse 
principal 	princip
principale 	princip
principales 	princip
principauté 	princip
principaux 	princip
principe 	princip
printemps 	printemps 
période 	péri
priorité 	priorité
priorités 	priorité
prière 	prière
prières 	prière
priés 	priés 
priés 	priés 
pris 	pris 
pris 	pris 
pris 	pris 
prise 	prise 
prises 	prises 
prisme 	prisme 
prison 	prison
prisonnier 	prison
prisonniers 	prison
prisonnière 	prison
prisonnières 	prison
prisons 	prison
pristina 	pristina 
privé 	privé 
privatisation 	privatisation 
privée 	privée
privées 	privée
privilégie 	privilégie
privilégient 	privilégie
privilégier 	privilégie
privés 	privés 
prix 	prix 
priz 	priz 
préjudice 	préjudic
préjudiciable 	préjudic
prélat 	prélat 
prélever 	prélever 
prélèvement 	prélèvement 
prématurée 	prématurée 
prônant 	prôn
prônent 	prôn
pro 	pro 
probabilité 	prob
probable 	prob
probablement 	prob
probité 	prob
problématique 	prob
problème 	prob
problèmes 	prob
préoccupé 	préoccup
préoccupait 	préoccup
préoccupant 	préoccup
préoccupations 	préoccup
procédé 	proc
procéder 	proc
procédure 	proc
procédures 	proc
processus 	proc
prochain 	proc
prochaine 	proc
prochainement 	proc
prochaines 	proc
prochains 	proc
proche 	proc
proches 	proc
proclamé 	proc
proclamation 	proc
procréation 	proc
procès 	proc
procureur 	proc
prodi 	prod
producteur 	product
production 	product
produit 	produit
produite 	produit
produites 	produit
profanation 	prof
professent 	prof
professeur 	prof
professeurs 	prof
profil 	prof
profile 	prof
profitant 	prof
profond 	prof
profonde 	prof
profondeur 	prof
profondément 	prof
programme 	progr
programmes 	progr
progressé 	progress
progressaient 	progress
progressait 	progress
progresse 	progress
progresser 	progress
progressif 	progress
progression 	progress
progressiste 	progress
progressivement 	progress
progrès 	progr
proie 	proie 
projet 	projet
projet 	projet
projeté 	projet
projetée 	projet
projets 	projet
projette 	projet
prolifération 	prol
prolongeait 	prolonge
prolongent 	prolonge
prolonger 	prolonge
prolongera 	prolonge
promet 	prom
promettait 	prom
promettent 	prom
promeut 	prom
promis 	prom
promotion 	prom
promulguée 	prom
prononcé 	prononc
prononcent 	prononc
prononcer 	prononc
prononcés 	prononc
pronostic 	pronostic
pronostics 	pronostic
propagé 	prop
propagande 	prop
propager 	prop
prophète 	prop
proportion 	prop
proportionnelle 	prop
propos 	prop
propos 	prop
propos 	prop
proposé 	prop
proposé 	prop
proposé 	prop
proposant 	prop
proposée 	prop
propose 	prop
propose 	prop
proposent 	prop
proposer 	prop
proposition 	prop
propositions 	prop
proposons 	prop
propre 	prop
propres 	prop
propriété 	prop
propriétaire 	prop
prostituées 	prostituées 
protagonistes 	prot
protection 	prot
protesté 	prot
protestant 	prot
protestants 	prot
protestataires 	prot
protestation 	prot
protestations 	prot
protestent 	prot
protester 	prot
protégé 	prot
protéger 	prot
protocolaire 	prot
protocole 	prot
pérou 	pérou 
prouvé 	prouv
éprouvantes 	éprouvantes 
prouver 	prouv
provenance 	prov
provenant 	prov
providence 	prov
proviennent 	prov
province 	prov
provinces 	prov
provisoire 	provisoire
provisoirement 	provisoire
provisoires 	provisoire
provocante 	prov
provocateurs 	prov
provocation 	prov
provoqué 	provoqu
provoquant 	provoqu
provoquée 	provoqu
provoquée 	provoqu
provoquée 	provoqu
provoquée 	provoqu
provoque 	provoqu
provoque 	provoqu
provoque 	provoqu
provoque 	provoqu
provoquer 	provoqu
provoqués 	provoqu
proximité 	proximité 
préparé 	prépar
préparaient 	prépar
préparait 	prépar
préparatifs 	prépar
préparation 	prépar
préparatoires 	prépar
prépare 	prépar
préparent 	prépar
préparer 	prépar
préparerait 	prépar
préparées 	prépar
préparés 	prépar
près 	près 
présence 	prés
présent 	prés
présent 	prés
présent 	prés
présent 	prés
présent 	prés
présenté 	prés
présenté 	prés
présenté 	prés
présenté 	prés
présentant 	prés
présentateur 	prés
présentation 	prés
présentée 	prés
présente 	prés
présente 	prés
présentent 	prés
présenter 	prés
présentes 	prés
présentés 	prés
présentés 	prés
présents 	prés
présents 	prés
préservatifs 	préserv
préserver 	préserv
présidait 	présid
présidant 	présid
présidée 	présid
présidence 	présid
président 	présid
présidente 	présid
présidentiel 	présid
présidentielle 	présid
présidentielles 	présid
présidents 	présid
présidera 	présid
présumé 	présumé
présumée 	présumé
présumés 	présumé
prêt 	prêt 
prêt 	prêt 
prêté 	prêté 
prête 	prête 
prétendants 	prétend
prétendre 	prétend
prétendu 	prétend
prêtes 	prêtes 
prétoire 	prétoire 
prêtre 	prêtre
prêtres 	prêtre
prêts 	prêts 
prudence 	pruden
prudent 	pruden
préval 	prév
prévenir 	prév
prévention 	prév
prévenu 	prév
prévient 	prév
prévision 	prév
prévisionnistes 	prév
prévisions 	prév
prévoit 	prév
prévoyant 	prév
prévu 	prév
prévue 	prév
prévues 	prév
psb 	psb 
pèsent 	pèsent 
psg 	psg 
psychologique 	psychologique
psychologiquement 	psychologique
psychologiques 	psychologique
psychose 	psycho
pétersbourg 	pétersbourg 
pétitionnaires 	pétitionnaires 
pétrole 	pétrol
pétrolier 	pétrolier
pétroliers 	pétrolier
pétrolière 	pétrolière
pétrolières 	pétrolière
pu 	pu 
publié 	publi
public 	publi
publication 	publi
publications 	publi
publics 	publi
publiée 	publi
publie 	publi
publient 	publi
publier 	publi
publiées 	publi
publique 	publi
publiquement 	publi
publiques 	publi
publiés 	publi
pubs 	pubs 
pucallpa 	pucallpa 
pugnace 	pugnace 
puis 	puis
puiser 	puis
puisqu 	puis
épuisés 	épuisés 
puissance 	puis
puissances 	puis
puissant 	puis
puissante 	puis
puits 	puits 
pulmonaire 	pulmonaire 
punis 	punis 
purement 	purement 
purgeait 	purgeait 
putrides 	putrides 
putsch 	putsch
putschistes 	putsch
pyjama 	pyjama 
qaïda 	qaïda 
qaida 	qaida 
qatada 	qata
qatar 	qata
qatariote 	qata
qcm 	qcm 
qi 	qi 
qods 	qods 
qu 	qu 
quadruple 	quadruple 
quai 	quai 
quais 	quais 
qualifié 	qualifi
qualifiée 	qualifi
qualifient 	qualifi
qualité 	quali
quand 	quand 
quant 	quant 
quarantaine 	quarant
quarante 	quarant
quart 	quart 
quartette 	quartette 
quartier 	quartier
quartiers 	quartier
quarts 	quarts 
quasi 	quasi
quasiment 	quasi
équatorien 	équatorien 
quatorze 	quatorz
quatorzième 	quatorz
quatre 	quatre 
quatrième 	quatrième 
québec 	québec 
quel 	quel 
que la 	que la 
quelle 	quelle
quelles 	quelle
quelque 	quelque
quelques 	quelque
quels 	quels 
quentin 	quentin 
querelles 	querelles 
question 	question
questions 	question
 qui 	 qui 
qui 	qui 
qui 	qui 
quinzaine 	quinz
quinze 	quinz
équipage 	équi
équipée 	équi
équipe 	équi
équipes 	équi
équitable 	équi
quitté 	quitt
quittait 	quitt
quitte 	quitt
quittent 	quitt
quitter 	quitt
équivalent 	équi
quoi 	quoi 
quorum 	quorum 
quotidien 	quotidien
quotidienne 	quotidien
quotidiens 	quotidien
raï 	raï 
rabais 	rabais 
rabin 	rabin 
rachat 	rachat 
rachid 	rachid 
raciale 	raciale 
raciste 	raciste
racistes 	raciste
raconté 	racont
raconte 	racont
racontent 	racont
réacteur 	réacteur
réacteurs 	réacteur
réaction 	réaction
réactions 	réaction
réactivé 	réact
radar 	radar 
radical 	radica
radicalement 	radica
radicales 	radica
radicalisées 	radicalisé
radicalisés 	radicalisé
radicaux 	radica
radiée 	radiée 
radio 	radio 
radios 	radios 
radioscopie 	radioscopie 
rafah 	rafah 
raffarin 	raffarin 
réaffectés 	réaffectés 
raffinerie 	raffinerie
raffineries 	raffinerie
réaffirmé 	réaffirm
réaffirme 	réaffirm
rafic 	rafic 
raflant 	raflant 
rafle 	rafle 
rafsandjani 	rafsandjani 
rafting 	rafting 
rage 	rage 
réagi 	réagi
réagir 	réagi
réagissant 	réagi
réagissent 	réagi
réagit 	réagi
ragot 	ragot 
rahman 	rahman
rahmane 	rahman
raid 	raid 
raide 	raide 
raids 	raids 
rails 	rails 
raimondas 	raimondas 
rainbow 	rainbow 
rainier 	rainier 
raison 	raison
raisonnable 	raison
raisons 	raison
rajeunissement 	rajeunissement 
ralentissement 	ralentissement 
réalisé 	réalis
réalisateur 	réalis
réalisée 	réalis
réalise 	réalis
réalisés 	réalis
rallier 	rall
rallonge 	rallonge
rallonger 	rallonge
ramassaient 	ramassaient 
ramda 	ramda 
rame 	rame 
rameaux 	rameaux 
ramené 	ramené 
rames 	rames 
réaménagée 	réaménag
réaménagement 	réaménag
ramper 	ramper 
ranch 	ranch 
randonnée 	randonnée 
rang 	rang 
rangoun 	rangoun 
rangs 	rangs 
réanimation 	réanimation 
rançon 	rançon 
raouf 	raouf 
rapatrié 	rapatri
rapatriement 	rapatri
rapatrier 	rapatri
rapatriés 	rapatri
rapide 	rapide
rapidement 	rapide
rappatrié 	rappatrié 
rappelé 	rappelé 
rappelant 	rappelant 
rappelle 	rappelle 
rappeur 	rappeur 
rapport 	rapport
rapporte 	rapport
rapproché 	rapproch
rapproche 	rapproch
rapprochement 	rapproch
rapprochent 	rapproch
réapprovisionner 	réapprovisionner 
rapt 	rapt 
rare 	rare
rares 	rare
raïs 	raïs 
rassemblant 	rassembl
rassemblée 	rassembl
rassemble 	rassembl
rassemblement 	rassembl
rassemblements 	rassembl
rassemblent 	rassembl
rassembler 	rassembl
rassemblées 	rassembl
rassemblés 	rassembl
rassuré 	rassur
rassurants 	rassur
rassure 	rassur
rassurer 	rassur
raté 	raté 
ratées 	ratées 
ratifié 	ratifi
ratification 	ratifi
ratifications 	ratifi
ratifier 	ratifi
ratko 	ratko 
ratés 	ratés 
rats 	rats 
rattachement 	rattachement 
rattrapé 	rattrap
rattraper 	rattrap
ratzinger 	ratzinger 
ravagé 	ravag
ravagée 	ravag
ravage 	ravag
ravagées 	ravag
ravages 	ravag
ravin 	ravin 
ravir 	ravir 
ravisseur 	ravisseur
ravisseurs 	ravisseur
ray 	ray 
rayé 	rayé 
rayer 	rayer 
raz 	raz 
rébellion 	rébellion 
récemment 	récemment 
récent 	récent
récente 	récent
récentes 	récent
récents 	récent
réchauffement 	réchauffement 
récidive 	récidive 
récit 	récit 
récits 	récits 
réclamé 	réclam
réclamant 	réclam
réclamée 	réclam
réclame 	réclam
réclame 	réclam
réclament 	réclam
réclamer 	réclam
réclamés 	réclam
récoltés 	récoltés 
récompense 	récompense
récompenses 	récompense
réconciliation 	réconcili
réconcilitation 	réconcili
récupéré 	récupér
récupérer 	récupér
récupérés 	récupér
rda 	rda 
rédaction 	rédaction 
rdc 	rdc 
rééducation 	rééducation 
réduction 	rédu
réduire 	rédu
réduit 	rédu
réduite 	rédu
ère 	ère 
rebelles 	rebelles 
rebondir 	rebondi
rebondissement 	rebondi
rebours 	rebours 
rebranché 	rebranch
rebranchée 	rebranch
rebranchement 	rebranch
rebrousser 	rebrousser 
recadre 	recadre 
recensés 	recensés 
recevabilité 	recevabilité 
recevait 	recevait 
recevant 	recevant 
recevoir 	recevoir 
recherché 	recherch
recherchaient 	recherch
recherche 	recherch
recherches 	recherch
recherchés 	recherch
reclassé 	reclassé 
reclu 	reclu 
recommandé 	recommandé 
recomptage 	recomptage 
reconduit 	reconduit 
reconnaissance 	reconnaissan
reconnaissant 	reconnaissan
reconnaît 	reconnaît
reconnaître 	reconnaît
reconnu 	reconnu 
reconnue 	reconnue 
reconstitué 	reconstitu
reconstitution 	reconstitu
reconstruction 	reconstru
reconstruire 	reconstru
reconverti 	reconverti 
record 	record
records 	record
recourir 	recour
recours 	recour
recréer 	recréer 
recrudescence 	recrudescence 
recrues 	recrues 
recrutement 	recrute
recruter 	recrute
recteur 	recteur 
recueillait 	recueill
recueille 	recueill
recueillement 	recueill
recueilli 	recueill
recueillie 	recueill
recueillies 	recueill
recueillir 	recueill
recule 	recule 
red 	red 
redevenant 	redevenant 
redit 	redit 
redémarré 	redémarré 
redonneront 	redonneront 
redorer 	redorer 
redoublement 	redoublement 
redouté 	redouté 
redoutaient 	redoutaient 
redoutent 	redoutent 
redouter 	redouter 
redoutées 	redoutées 
redoutés 	redoutés 
refaire 	refaire 
reflux 	reflux 
refonte 	refonte 
refoulé 	refoulé 
refus 	refus
refus 	refus
refus 	refus
refus 	refus
refus 	refus
refusé 	refus
refusé 	refus
refusé 	refus
refusé 	refus
refusé 	refus
refusé 	refus
refusant 	refus
refuse 	refus
refusent 	refus
regagner 	regagner 
regain 	regain 
regard 	regard
regards 	regard
regrette 	regrette 
regroupant 	regroup
regroupement 	regroup
regroupés 	regroup
reichenhall 	reich
reichstag 	reich
reine 	reine 
rejet 	rejet
rejet 	rejet
rejet 	rejet
rejet 	rejet
rejet 	rejet
rejeté 	rejet
rejeté 	rejet
rejeté 	rejet
rejeté 	rejet
rejeté 	rejet
rejeté 	rejet
rejetée 	rejet
rejetées 	rejet
rejette 	rejet
rejettent 	rejet
rejoindre 	rejoin
rejoint 	rejoin
rejugé 	rejugé 
réel 	réel
relais 	relais 
relancé 	relanc
relance 	relanc
relancer 	relanc
relatif 	relati
relation 	relati
relations 	relati
relative 	relati
relativement 	relati
relâché 	relâch
relâcher 	relâch
relâchés 	relâch
relevé 	relev
relever 	relev
reliant 	reliant 
religieuse 	religieu
religieux 	religieu
religion 	religi
réelle 	réel
relogement 	relogement 
relève 	relève
relèverait 	relève
remaniée 	remaniée 
remarquer 	remarquer 
remercie 	remercie 
remet 	remet 
remis 	remis
remise 	remis
remontait 	remont
remontée 	remont
remontée 	remont
remonte 	remont
remonte 	remont
rempart 	rempart 
remplacé 	remplac
remplacement 	remplac
remplacer 	remplac
rempli 	rempli 
remplies 	remplies 
remporté 	remport
remportait 	remport
remportant 	remport
remporte 	remport
remporterait 	remport
remportées 	remport
rené 	rené 
rencontré 	rencontr
rencontrait 	rencontr
rencontre 	rencontr
rencontrer 	rencontr
rencontrera 	rencontr
rencontrées 	rencontr
rencontres 	rencontr
rend 	rend 
rendant 	rendant 
rendez 	rendez 
rendra 	rendra 
rendraient 	rendraient 
rendre 	rendre 
rendu 	rendu 
rendue 	rendue 
rendues 	rendues 
rendus 	rendus 
renforçant 	renfor
renforcé 	renfor
renforcée 	renfor
renforcée 	renfor
renforce 	renfor
renforcement 	renfor
renforcer 	renfor
renforcées 	renfor
renfort 	renfor
renforts 	renfor
renégocier 	renégocier 
renoncé 	renonc
renonce 	renonc
renoncer 	renonc
renonciation 	renonc
renoue 	renoue 
renouvelé 	renouvel
renouvelées 	renouvel
renouvellement 	renouvelle
renouvellent 	renouvelle
renseignement 	renseignement
renseignements 	renseignement
rentré 	rentr
rentrée 	rentr
rentre 	rentr
rentrer 	rentr
renversé 	renversé 
renvoi 	renvoi 
renvoie 	renvoie 
renvoient 	renvoient 
renvoyé 	renvoyé 
renvoyer 	renvoyer 
renvoyés 	renvoyés 
reçoit 	reçoit 
repart 	repart
reparti 	repart
repartir 	repart
repas 	repas 
repassé 	repassé 
repêchés 	repêchés 
repetita 	repetita 
replacer 	replacer 
repli 	repli 
report 	report
reporté 	report
reporté 	report
reportait 	report
reportée 	report
reporter 	report
reporters 	report
reportées 	report
repose 	repose
reposer 	repose
repoussé 	repouss
repousser 	repouss
repoussés 	repouss
repéré 	repéré 
reprend 	repren
reprendra 	repren
reprendrait 	repren
reprendre 	repren
reprendront 	repren
reprennent 	repren
repris 	repris
reprise 	repris
reprises 	repris
reproche 	reproche 
reproduit 	reproduit 
reproposé 	reproposé 
représailles 	représ
représentait 	représent
représentant 	représentant
représentants 	représentant
représente 	représent
repubblica 	repubblica 
requis 	requis
requise 	requis
rescapé 	rescapé
rescapés 	rescapé
rescousse 	rescousse 
respect 	respect
respecter 	respect
respectifs 	respect
respectivement 	respect
respectueux 	respect
respiration 	respirat
respiratoires 	respirat
respire 	respir
respirer 	respir
responsabilité 	responsabilité
responsabilités 	responsabilité
responsable 	responsable
responsables 	responsable
responsables syriens 	responsable
ressenti 	ressenti
ressentie 	ressenti
ressentir 	ressenti
ressortissant 	ressortissant
ressortissants 	ressortissant
resté 	resté 
restait 	restait 
restant 	restant 
restaurants 	restaur
restaurer 	restaur
restée 	restée 
reste 	reste 
reste 	reste 
restent 	restent 
rester 	rester
restera 	rester
resterait 	rester
restes 	restes 
restrictives 	restrictives 
restés 	restés 
retard 	retard
retardée 	retard
retarder 	retard
retards 	retard
retenait 	reten
retenu 	reten
retenue 	reten
retenus 	reten
retiendra 	retien
retient 	retien
retiré 	retiré 
retirée 	retirée 
retire 	retire 
retire 	retire 
retirer 	retirer
retirerait 	retirer
retirées 	retirées 
retirés 	retirés 
retour 	retour
retourné 	retour
retourne 	retour
retourner 	retour
retrace 	retrace
retracent 	retrace
retrait 	retrait
retraite 	retrait
retranché 	retranché
retranchés 	retranché
retransmises 	retransmises 
retrouvé 	retrouv
retrouvailles 	retrouv
retrouvait 	retrouv
retrouvée 	retrouv
retrouvée 	retrouv
retrouvée 	retrouv
retrouve 	retrouv
retrouve 	retrouv
retrouve 	retrouv
retrouvent 	retrouv
retrouver 	retrouv
retrouvées 	retrouv
retrouvez 	retrouv
retrouvés 	retrouv
reçu 	reçu
reçue 	reçu
reçus 	reçu
revanché 	revanch
revanche 	revanch
revécu 	revécu 
revenait 	revenait 
revendication 	revendication
revendications 	revendication
revendiqué 	revendiqu
revendiquée 	revendiqu
revendiquée 	revendiqu
revendique 	revendiqu
revendique 	revendiqu
revendique 	revendiqu
revendiquent 	revendiqu
revendiquer 	revendiqu
revenir 	revenir 
revenu 	revenu 
revers 	revers 
reviennent 	revien
revient 	revien
revigorer 	revigorer 
revivre 	revivre 
revoir 	revoir 
revu 	revu 
revue 	revue 
réexaminer 	réexaminer 
rfa 	rfa 
réfléchit 	réfléchit 
réformateur 	réform
réforme 	réform
réformes 	réform
référence 	référen
référendaire 	référen
référendum 	référendum
référendums 	référendum
réfugier 	réfugi
réfugiés 	réfugi
rg 	rg 
régence 	régence 
régime 	régime
régimes 	régime
région 	région
régional 	région
régionales 	région
régions 	région
réglé 	réglé 
réglée 	réglée 
règle 	règle
règlement 	règle
régler 	régler
réglera 	régler
règles 	règle
règnait 	règnait 
régnant 	régnant 
règne 	règne 
régulièrement 	régulièrement 
rhabiller 	rhabiller 
rhin 	rhin 
rhénanie 	rhénanie 
ricard 	ricard
ricardo 	ricard
rice 	rice 
richard 	richard 
riche 	riche 
richter 	richter 
rien 	rien 
rights 	rights 
rigoureuse 	rigoureu
rigoureux 	rigoureu
réincarcération 	réin
réinstallation 	réin
rio 	rio 
riposté 	ripost
riposte 	ripost
ripostera 	ripost
rire 	rire 
risque 	risque
risquent 	risque
risques 	risque
ristourne 	ristourne 
rita 	rita 
rite 	rite 
réitère 	réit
réitérer 	réit
rival 	rival 
rivale 	rivale 
rivaux 	rivaux 
rive 	rive 
rizkar 	rizkar 
rôle 	rôle 
réélection 	réélection 
réélire 	réélire 
réélu 	réélu
réélue 	réélu
rênes 	rênes 
rénégociation 	rénégociation 
robe 	robe 
robert 	robert
roberto 	robert
robertson 	robert
robin 	robin 
robles 	robles 
robot 	robot
robotisé 	robot
roccasecca 	roccasecca 
rocher 	rocher 
rock 	rock 
érodé 	érodé 
rodney 	rodney 
rodriguez 	rodriguez 
roi 	roi 
roissy 	roissy 
roland 	roland 
romain 	romain 
roman 	roman 
romano 	romano 
rome 	rome 
rompt 	rompt 
rompu 	rompu 
réopérée 	réopérée 
roquette 	roquette
roquettes 	roquette
rosa 	rosa
rosaire 	rosa
rotenbourg 	rotenbourg 
roues 	roues 
rouge 	rouge 
roulait 	roulait 
roulant 	roulant 
rouler 	rouler 
roumain 	roumain
roumaines 	roumain
roumains 	roumain
roumanie 	rouma
rousse 	rousse 
route 	route
routes 	route
rouvert 	rouvert 
réouverture 	réouverture 
rouvrir 	rouvrir 
rove 	rove 
roy 	roy 
royal 	royal 
royales 	royales 
royaume 	royaume 
répandue 	répandue 
répercussions 	réper
répertoriant 	réper
réplique 	réplique
répliques 	réplique
répondent 	répon
répondre 	répon
répondrons 	répon
répondu 	répon
réponse 	réponse
réponses 	réponse
répression 	répression 
réprimée 	réprim
réprimer 	réprim
réprésailles 	réprésailles 
répétition 	répétition 
républicain 	républicain
républicaine 	républicain
républicains 	républicain
république 	républi
réputé 	réputé 
réseau 	réseau
réseaux 	réseau
réservé 	réserv
réserve 	réserv
réserves 	réserv
rsf 	rsf 
réside 	réside
résident 	résident
résidentiel 	résident
résidents 	résident
résisté 	résist
résistance 	résist
résolues 	résolu
résolument 	résolu
résolution 	résolu
résoudre 	réso
résultat 	résultat
résultats 	résultat
résume 	résu
râté 	râté 
rétablie 	rétabli
rétablies 	rétabli
rétablir 	rétabli
rétablissement 	rétabli
rétention 	rétention 
réticences 	réticences 
rétrogradé 	rétrogradé 
rue 	rue 
rues 	rues 
rugova 	rugova 
ruines 	ruines 
rumeurs 	rumeurs 
rumsas 	rumsas 
rumsfeld 	rumsfeld 
réuni 	réuni
réunie 	réuni
réunies 	réuni
réunification 	réuni
réunion 	réuni
réunions 	réuni
réunir 	réuni
réunira 	réuni
réuniront 	réuni
réunis 	réuni
réunissait 	réuni
réunissent 	réuni
réunit 	réuni
rural 	rural 
rushing 	rushing 
russe 	russe 
russel 	russel 
russell 	russell 
russes 	russes 
réussi 	réussi
russie 	russie 
réussite 	réussi
ruth 	ruth 
rêve 	rêve 
réveil 	réveil
réveillon 	réveillon
réveillonné 	réveillon
révisé 	révis
révision 	révision
révisionnisme 	révision
révélé 	révélé 
révélation 	révélation
révélations 	révélation
révèle 	révèle
révèlent 	révèle
révéler 	révéler 
révolté 	révol
révolte 	révol
révolution 	révolution
révolutionnaires 	révolution
révulsé 	révuls
révulse 	révuls
rwanda 	rwanda
rwandais 	rwanda
rééxaminer 	rééxaminer 
ryad 	ryad 
rythme 	rythme 
sa 	sa 
saad 	saad
saadoun 	saad
sabaoui 	sabaoui 
sabbah 	sabbah 
saboter 	saboter 
sabrina 	sabrina 
sac 	sac 
sacerdoce 	sacerdoce 
sacré 	sacré 
sacre 	sacre 
sacrifices 	sacrifi
sacrifiés 	sacrifi
sacs 	sacs 
saddam 	saddam 
sadique 	sadique 
saffir 	saffir 
sahara 	sahara 
sahel 	sahel 
sain 	sain 
sains 	sains 
saint 	saint 
sainte 	sainte 
sainteté 	sainteté 
saints 	saints 
saisi 	saisi
saisie 	saisi
saisine 	saisi
saisir 	saisi
sait 	sait 
saito 	saito 
salafistes 	sala
salam 	sala
salariés 	sala
salle 	salle
salles 	salle
salon 	salon 
salué 	salu
saluant 	salu
salue 	salu
saluer 	salu
salut 	salu
salve 	salve
salves 	salve
samarra 	samarra 
samedi 	samedi 
samuel 	samuel 
san 	san 
sana 	sana 
séance 	séance 
sanction 	sanction
sanctionné 	sanction
sanctions 	sanction
sanctuaire 	sanct
sandra 	sandr
sandri 	sandr
sang 	sang
sanglant 	sanglant
sanglante 	sanglant
sanitaire 	sanitaire
sanitaires 	sanitaire
sanour 	sanour 
sans 	sans 
santé 	sant
santa 	sant
santiago 	sant
santorin 	sant
saoudien 	saoudien
saoudienne 	saoudien
saoudiennes 	saoudien
saoudiens 	saoudien
saoudite 	saoudi
sarajevo 	sarajevo 
sarkozy 	sarkozy 
satan 	satan 
satisfaire 	satisfai
satisfait 	satisfai
satisfaite 	satisfai
saturés 	saturés 
sauf 	sauf 
saufs 	saufs 
sauter 	sauter 
sauvé 	sauvé 
sauvée 	sauvée 
sauvegarder 	sauvegarder 
sauver 	sauver 
sauvetage 	sauvetage
sauvetages 	sauvetage
sauveteurs 	sauvet
sauvés 	sauvés 
savaient 	savai
savait 	savai
save 	save 
savoir 	savoir 
saxonne 	saxonne 
sbs 	sbs 
scandale 	scandale
scandaleux 	scandale
scellé 	scell
sceller 	scell
scellés 	scell
sceptiques 	sceptiques 
sécession 	sécession 
schengen 	schengen 
schiavo 	schiavo 
schiphol 	schiphol 
schockenhoff 	schockenhoff 
schröder 	schröder 
schroeder 	schroeder 
schwarzenegger 	schwarz
schwarzy 	schwarz
sciences 	scien
scientifiques 	scien
scénario 	scénario
scénarios 	scénario
scène 	scène
scènes 	scène
scolaire 	scolaire
scolaires 	scolaire
score 	score
scores 	score
scotland 	scotland 
scott 	scott 
scruter 	scrut
scrutin 	scrutin
scrutins 	scrutin
sécurisé 	sécuri
sécurité 	sécuri
sécuritaire 	sécuri
sédation 	sédation 
sdf 	sdf 
sdérot 	sdérot 
sean 	sean 
sebastian 	sebastian 
second 	second
seconde 	second
secondes 	second
secoué 	secoué 
secoue 	secoue 
secouent 	secouent 
secouristes 	secouristes 
secours 	secours 
secoués 	secoués 
secousse 	secousse
secousses 	secousse
secret 	secret
secrets 	secret
secrétaire 	secrétaire 
secrète 	secrète
secrètes 	secrète
secteur 	secteur
secteurs 	secteur
securitas 	securitas 
sein 	sein 
seine 	seine 
seize 	seize 
seleçao 	seleçao 
seller 	selle
sellette 	selle
selon 	selon 
semé 	semé 
semaine 	semaine
semaines 	semaine
semant 	semant 
semblait 	sembl
semble 	sembl
semblent 	sembl
semer 	semer 
senji 	senji 
sens 	sens 
sensibilisée 	sensibili
sensibilité 	sensibili
sensibles 	sensib
sentent 	sentent 
senti 	senti 
sentie 	sentie 
sentiment 	sentiment
sentiments 	sentiment
sept 	sept
septembre 	sept
septième 	sept
sera 	sera 
seraient 	seraient 
serait 	serait 
serbe 	serbe 
serbes 	serbes 
serbie 	serbie 
serein 	serein 
serge 	serge 
serial 	serial 
serment 	serment 
sermonne 	sermonne 
serons 	seron
seront 	seron
serré 	serré
serrée 	serré
se résoudre 	se résoudre 
sert 	sert 
servant 	servant 
service 	service
services 	service
servir 	servir 
ses 	ses 
session 	session 
seuil 	seuil 
seul 	seul 
seule 	seule 
seulement 	seulement 
seules 	seules 
seuls 	seuls 
seurat 	seurat 
sexagénaire 	sexagénaire 
sexe 	sexe 
sexes 	sexes 
sexuel 	sexuel
sexuelle 	sexuel
sexuels 	sexuel
sgrena 	sgrena 
shabbat 	shabbat 
shanghai 	shanghai 
sharon 	sharon
sharonisme 	sharonis
sharoniste 	sharonis
sheehan 	sheehan 
shepherd 	shepherd 
sherpas 	sherpas 
shimon 	shimon 
shirat 	shirat 
shiva 	shiva 
shoah 	shoah 
shoot 	shoot 
shore 	shore 
show 	show 
si 	si 
sibérienne 	sibérienne 
sicario 	sicario 
sicile 	sicile 
siècle 	siècle
siècles 	siècle
sida 	sida 
sidique 	sidique 
sifflements 	sifflements 
siège 	siège
sièges 	siège
signé 	sign
signal 	sign
signalé 	sign
signalée 	sign
signalés 	sign
signature 	sign
signée 	sign
signe 	sign
signe 	sign
signer 	sign
signera 	sign
signifié 	sign
significatif 	sign
significative 	sign
signifie 	sign
signifierait 	sign
signoles 	sign
sil 	sil 
silence 	silenc
silencieux 	silenc
sillage 	sillage 
silva 	silva 
silvio 	silvio 
simeulue 	simeulue 
simon 	simon
simona 	simon
simple 	simple
simplement 	simple
simpson 	simpson 
simultanées 	simultané
simultanément 	simultané
sinaï 	sinaï 
sinabang 	sinabang 
sincères 	sincères 
sine 	sine 
singapour 	singapour 
singulier 	singulier 
sinistrée 	sinistr
sinistre 	sinistr
sinistrées 	sinistr
sinistrés 	sinistr
sinon 	sinon 
sirleaf 	sirleaf 
séisme 	séisme 
sismique 	sismique
sismiques 	sismique
site 	site 
sites 	sites 
sitôt 	sitôt 
situé 	situé 
situation 	situation 
située 	située 
situe 	situe 
six 	six 
sixtine 	sixtine 
séjour 	séjour
séjours 	séjour
ski 	ski 
sky 	sky 
slapping 	slapping 
slave 	slave 
sélection 	sélection
sélectionner 	sélection
slikken 	slikken 
slip 	slip 
sèment 	sèment 
séminaire 	sémi
sémite 	sémi
smoking 	smoking 
sms 	sms 
sénat 	sénat
sénateurs 	sénat
sénégal 	sénégal
sénégalais 	sénégal
sniper 	sniper 
sobre 	sobre 
social 	social 
sociale 	sociale 
socialisme 	socialisme 
socialiste 	socialiste
socialistes 	socialiste
socialites 	socialites 
sociaux 	sociaux 
sociologue 	sociologue 
société 	société
sociétés 	société
socrate 	socrate 
sodano 	sodano 
sofres 	sofres 
soi 	soi 
soient 	soient 
soigné 	soigné 
soins 	soins 
soir 	soir 
soirée 	soirée 
soirs 	soirs 
soit 	soit 
soixantaine 	soixant
soixante 	soixant
soixantième 	soixant
sol 	sol 
soldat 	soldat
soldate 	soldat
soldats 	soldat
sole 	sole 
solennelle 	solennelle
solennellement 	solennelle
solidarité 	solidarité
solidarités 	solidarité
solide 	solide 
solitaire 	solitaire 
sollicité 	sollicit
sollicitude pour 	sollicit
solution 	solution
solutions 	solution
sombrait 	sombrait 
sommé 	sommé 
sommant 	sommant 
sommée 	sommée 
somme 	somme 
sommes 	sommes 
sommet 	sommet 
sondage 	sondage
sondages 	sondage
sonde 	sonde 
sondés 	sondés 
sonné 	sonné
sonnée 	sonné
sonore 	sonore 
sont 	sont 
sophie 	sophie 
sordide 	sordide 
sort 	sort 
sortant 	sortant 
sortent 	sortent 
sorti 	sorti 
sortie 	sortie 
sortir 	sortir 
sortis 	sortis 
sos 	sos 
sosoliso 	sosoliso 
souche 	souche 
soudan 	soudan
soudanaise 	soudan
soueïra 	soueïra 
souffle 	souff
souffrait 	souff
souffrance 	souff
souffrant 	souff
souffrent 	souff
souffriraient 	souff
souhait 	souhait
souhaité 	souhait
souhaite 	souhait
souhaitent 	souhait
souk 	souk 
souks 	souks 
soulagement 	soulagement 
soulevé 	soulevé 
souligné 	soulign
soulignant 	soulign
souligne 	soulign
soulignent 	soulign
soulève 	soulève 
soumettre 	soumettre 
soumis 	soumis 
soupe 	soupe 
soupçonné 	soupçonné
soupçonnées 	soupçonné
soupçonnés 	soupçonné
soupçons 	soupçon
source 	source
sources 	source
sourd 	sourd 
sourire 	sourire 
sous 	sous 
sousin 	sousin 
soussan 	soussan 
soutenir 	soutenir 
soutenu 	soutenu 
soutenue 	soutenue 
souterrain 	souterrain 
soutien 	soutien
soutient 	soutien
souvenir 	souvenir 
souvent 	souvent 
souverain 	souverain
souverainiste 	souverain
souviennent 	souvien
souvient 	souvien
soviétique 	soviétique 
soyez 	soyez 
séparant 	sépar
séparatiste 	séparatiste
séparatistes 	séparatiste
séparée 	sépar
spécial 	spéc
spécialisé 	spécialis
spécialisée 	spécialis
spécialisées 	spécialis
spécialiste 	spécialiste
spécialistes 	spécialiste
spéciaux 	spéc
spécifique 	spéc
spéculations 	spécul
spécule 	spécul
spd 	spd 
spectaculaire 	spectaculaire 
spielberg 	spielberg 
spinetta 	spinetta 
spirale 	spirale 
spirituel 	spirituel
spirituelles 	spirituel
spontané 	spontané 
sportif 	sportif 
sprint 	sprint 
spuiten 	spuiten 
square 	square 
séquestration 	séquestr
séquestre 	séquestr
sûr 	sûr 
sûre 	sûre 
srebrenica 	srebrenica 
sri 	sri 
série 	série
série d 	série
sérieusement 	série
sérieuses 	série
sérieux 	série
st 	st 
stabilisation 	stabilis
stabilisées 	stabilis
stable 	stable 
stade 	stade 
stan 	stan 
stanley 	stanley 
star 	star 
stark 	stark 
stars 	stars 
state 	state 
station 	station
station balnéaire 	station
stationnaire 	station
stations 	station
statut 	statut 
stephen 	stephen 
steven 	steven 
steward 	stewar
stewart 	stewar
sétif 	sétif 
stèles 	stèles 
stockholm 	stock
stockwell 	stock
stoiber 	stoiber 
stopper 	stopper 
stéphane 	stéphane 
stratèges 	stratèges 
stratégie 	stratégie 
straw 	straw 
street 	street 
stress 	stress 
stricte 	stricte 
style 	style 
su 	su 
subi 	subi 
subie 	subie 
subir 	subir 
subis 	subis 
subissent 	subissent 
subit 	subit 
subite 	subite 
submergé 	submergé 
substance 	substance 
succède 	succ
succèdent 	succ
succéder 	succ
succédera 	succ
successeur 	succ
successeurs 	succ
succession 	succ
successives 	succ
succombé 	succ
succès 	succ
sud 	sud 
suède 	suède 
suédoise 	suédoise 
suez 	suez 
suffi 	suff
suffit 	suff
suffrage 	suffrage
suffrages 	suffrage
suggérant 	sugg
suggère 	suggère
suggèrent 	suggère
suicidé 	suicid
suicide 	suicid
suicides 	suicid
suis 	suis 
suisse 	suisse
suisses 	suisse
suit 	suit 
suite 	suite 
suites 	suites 
suivante 	suivante 
suivi 	suivi 
suivie 	suivie 
suivre 	suivre 
suivront 	suivront 
sujet 	sujet
sujets 	sujet
sulfureux 	sulfureux 
sumatra 	sumatra 
sun 	sun 
sunday 	sunday 
sunnite 	sunnite
sunnites 	sunnite
sunshine 	sunshine 
supermarché 	super
superviser 	super
supplémentaire 	supplémentaire
supplémentaires 	supplémentaire
supporters 	supporters 
supprimer 	supprimer 
supérieurs 	supérieurs 
suprématie 	suprématie 
suprême 	suprême 
surenchère 	surenchère 
surfeurs 	surfeurs 
surmonter 	surmonter 
surnomment 	surnomment 
surprise 	surprise
surprises 	surprise
surptise 	surptise 
surs 	surs 
sursis 	sursis 
surtout 	surtout 
survécu 	survécu 
surveillaient 	surveill
surveillance 	surveill
surveillée 	surveill
survenir 	survenir 
survenu 	survenu 
survenue 	survenue 
survenues 	survenues 
surviennent 	survien
survient 	survien
survivant 	survivant
survivants 	survivant
survol 	survol 
susanne 	susanne 
susceptibles 	susceptibles 
suscité 	suscit
suscite 	suscit
susciter 	suscit
suse 	suse 
suspect 	suspect
suspect 	suspect
suspect 	suspect
suspect 	suspect
suspecté 	suspect
suspecté 	suspect
suspecté 	suspect
suspectés 	suspect
suspects 	suspect
suspend 	suspe
suspendre 	suspe
suspendu 	suspe
suspendue 	suspe
suspendues 	suspe
suspens 	suspe
suspense 	suspe
suspension 	suspe
sussex 	sussex 
sévices 	sévices 
sévir 	sévir 
sévissent 	sévissent 
sévit 	sévit 
sévèrement 	sévèrement 
sydney 	sydney 
symbole 	symbol
symbolique 	symbol
symbolisant 	symbol
sympathisants 	sympathisants 
synagogue 	synagogue
synagogues 	synagogue
syndicalistes 	syndica
syndicat 	syndica
syndicats 	syndica
syndrome 	syndrome 
synode 	synode 
syriana 	syri
syrie 	syri
syrien 	syri
syrienne 	syrienne
syriennes 	syrienne
syriens 	syri
systématique 	syst
système 	système
systèmes 	système
été 	été 
été 	été 
été 	été 
été 	été 
été 	été 
été 	été 
été 	été 
été 	été 
été 	été 
été 	été 
été 	été 
été 	été 
été 	été 
été 	été 
été 	été 
été 	été 
été 	été 
été 	été 
été 	été 
été 	été 
été 	été 
été 	été 
été 	été 
été 	été 
été 	été 
été 	été 
été 	été 
été 	été 
été 	été 
été 	été 
été 	été 
été 	été 
été 	été 
été 	été 
été 	été 
été 	été 
été 	été 
été 	été 
été 	été 
été 	été 
été 	été 
été 	été 
été 	été 
été 	été 
été 	été 
été 	été 
été 	été 
été 	été 
t 	t 
t 	t 
t 	t 
t 	t 
t 	t 
t 	t 
t 	t 
t 	t 
t 	t 
t 	t 
t 	t 
t 	t 
t 	t 
t 	t 
t 	t 
t 	t 
t 	t 
t 	t 
t 	t 
t 	t 
t 	t 
t 	t 
t 	t 
t 	t 
t 	t 
t 	t 
t 	t 
t 	t 
t 	t 
t 	t 
t 	t 
t 	t 
t 	t 
t 	t 
t 	t 
t 	t 
t 	t 
t 	t 
t 	t 
t 	t 
t 	t 
t 	t 
t 	t 
t 	t 
t 	t 
t 	t 
t 	t 
taba 	taba 
tabac 	tabac 
tabagisme 	tabagisme 
table 	table
tableau 	table
établie 	établi
établir 	établi
établissement 	établi
établissements 	établi
établissent 	établi
établit 	établi
tacite 	tacite 
tactique 	tactique
tactiques 	tactique
taddei 	taddei 
étages 	étages 
étaient 	étaient 
taipeh 	taipeh 
taire 	taire 
était 	était 
talabani 	talabani 
taliban 	taliban
talibans 	taliban
tall 	tall 
talonné 	talonné 
tamouls 	tamouls 
tampa 	tampa 
tandis 	tandis 
tanganyika 	tanganyika 
tans 	tans 
étant 	étant 
tant 	tant 
tant 	tant 
tanzanie 	tanzanie 
étape 	étape
étapes 	étape
tard 	tard 
tarek 	tarek 
taroudant 	taroudant 
état 	état 
taux 	taux 
taversé 	taversé 
taïwan 	taïwan 
taxe 	taxe 
taya 	taya 
tbilissi 	tbilissi 
tchadien 	tchadien 
tâche 	tâche 
tchèque 	tchèque 
tchétchène 	tchétchène
tchétchènes 	tchétchène
tchétchénie 	tchétch
techniciens 	techn
technique 	technique
techniques 	technique
technologie 	technologie
technologies 	technologie
tectoniques 	tectoniques 
éteint 	éteint
éteintes 	éteint
tel 	tel 
telegraph 	telegraph 
telle 	telle 
tels 	tels 
temoignages 	temoignages 
temporaire 	temporaire
temporairement 	temporaire
temporisé 	tempor
températures 	températures 
temps 	temps 
tempête 	tempête 
tenace 	tenace 
tenait 	tenait 
tenant 	tenant
tenants 	tenant
tend 	tend 
tendu 	tendu 
tendue 	tendue 
tenir 	tenir 
tension 	tension
tensions 	tension
tenté 	tenté 
tentait 	tentait 
tentative 	tentative
tentatives 	tentative
tente 	tente 
tentent 	tentent 
tenter 	tenter 
tenteraient 	tenteraient 
tenu 	tenu 
tenue 	tenue 
tenues 	tenues 
tenus 	tenus 
ôter 	ôter 
terme 	terme 
terminé 	termin
terminal 	termin
terminator 	termin
terminée 	termin
termine 	termin
termine 	termin
terminer 	termin
terminera 	termin
terrain 	terrain
terrains 	terrain
terras 	terras 
terre 	terre 
terrer 	terrer 
terres 	terres 
terrestre 	terrestre 
terreur 	terreur 
terri 	terri 
terrible 	terrible 
territoire 	territoire
territoires 	territoire
territoriales 	territo
terrorisait 	terroris
terrorisme 	terroris
terroriste 	terroris
terroristes 	terroris
terry 	terry 
test 	test
testé 	test
tests 	test
texane 	texane 
texas 	texas 
texte 	texte 
tf1 	tf1 
töging 	töging 
tgv 	tgv 
thé 	thé 
thaïlande 	thaïlande 
thatcher 	thatcher 
the 	the 
theo 	theo 
there 	there 
thierry 	thierry 
thèmes 	thèmes 
thomas 	thomas 
thoracique 	thoracique 
théoriciens 	théori
théorie 	théori
théoriquement 	théori
téhéran 	téhéran 
thriller 	thriller 
thèse 	thèse 
théâtre 	théâtre 
tiananmen 	tiananmen 
tiennent 	tiennent 
tient 	tient 
tiers 	tiers 
étiez 	étiez 
tigre 	tigre 
tikrit 	tikrit 
time 	time 
times 	times 
timide 	timide 
timochenko 	timochenko 
étincelles 	étincelles 
tir 	tir 
tiré 	tiré 
tiré 	tiré 
tirant 	tirant 
tirer 	tirer 
tirées 	tirées 
tirs 	tirs 
titre 	titre 
télécommandée 	télécommandée 
été libéré 	été libéré 
téléphoné 	téléphon
téléphone 	téléphon
téléphoniques 	téléphon
téléphérique 	téléph
téléréalité 	téléréalité 
téléspectateurs 	téléspectateurs 
télévangéliste 	télév
télévisé 	télévis
télévisée 	télévisée
télévisées 	télévisée
télévision 	télévision
télévisions 	télévision
témoigné 	témoign
témoignage 	témoign
témoignages 	témoign
témoigne 	témoign
témoignent 	témoign
témoigner 	témoign
témoin 	témoi
témoins 	témoi
ténacité 	ténacité 
tns 	tns 
to 	to 
togo 	togo
togolaise 	togo
toi 	toi 
étoiles 	étoiles 
toilettes 	toilettes 
toit 	toit
toits 	toit
tokyo 	tokyo 
tollé 	tollé 
tolérés 	tolérés 
tom 	tom 
tombée 	tombée 
tombe 	tombe 
tomber 	tomber 
tombées 	tombées 
tombés 	tombés 
ton 	ton 
tonbridge 	tonbridge 
tonnerre 	tonne
tonnes 	tonne
tony 	tony 
tookie 	tookie 
tories 	tories 
tornades 	tornades 
toronto 	toronto 
torrentielles 	torrent
torrents 	torrent
torretta 	torre
tort 	tort 
tortel 	tortel 
tortionnaire 	tortionnaire 
torturé 	tortur
torture 	tortur
torturées 	tortur
tortures 	tortur
tortures 	tortur
total 	total
totale 	total
totalement 	total
totalité 	total
touaregs 	touaregs 
touché 	touch
touchée 	touch
touchée 	touch
touchée 	touch
touche 	touch
touche 	touch
toucher 	touch
touchées 	touch
touchés 	touch
toueni 	toueni 
toujours 	toujours 
tour 	tour 
tourisme 	touris
touriste 	touris
touristes 	touris
touristique 	touristique
touristiques 	touristique
tourmente 	tourmente 
tourné 	tourné 
tournée 	tournée 
tourne 	tourne 
tournent 	tournent 
tourner 	tourner 
tournées 	tournées 
tous 	tous 
tout 	tout 
toute 	toute 
toutefois 	toutefois 
toutes 	toutes 
toxicologiques 	toxi
toxique 	toxi
tpi 	tpi 
tpiy 	tpiy 
tracée 	tracée 
trace 	trace 
trace 	trace 
traces 	traces 
trachéotomie 	trachéotomie 
tractations 	tractations 
trade 	trade 
tradition 	tradition
traditionnel 	traditionnel
traditionnelle 	traditionnel
traditionnellement 	traditionnel
traditionnels 	traditionnel
traducteur 	traduct
traduction 	traduct
traduire 	traduire 
traduit 	traduit 
trafalgar 	trafalgar 
trafic 	trafic 
tragédie 	tragédie 
tragique 	tragique 
traian 	traian 
train 	train 
trains 	trains 
trait 	trait 
trait 	trait 
trait 	trait 
traité 	traité 
traité 	traité 
traité 	traité 
traité 	traité 
traitement 	traitement
traitements 	traitement
traitent 	traitent 
trajectoire 	trajectoire 
étranger 	étranger
étrangers 	étranger
étrangère 	étrangère
étrangères 	étrangère
transaction 	trans
transatlantique 	trans
transfert 	trans
transformé 	trans
transforme 	trans
transformer 	trans
transformées 	trans
transféré 	trans
transférée 	trans
transférer 	trans
transférés 	trans
transitent 	trans
transition 	trans
transitoire 	trans
transmis 	trans
transmise 	trans
transparence 	trans
transport 	transport
transporté 	transport
transportait 	transport
transportant 	transport
transporter 	transport
transports 	transport
traque 	traque
traquent 	traque
travail 	travail
travaillait 	travailla
travaillant 	travailla
travaille 	travaille
travailler 	travaille
travailleraient 	travaille
travailliste 	travailliste
travaillistes 	travailliste
travaux 	travaux 
travers 	travers
travers 	travers
traversé 	travers
traverse 	travers
traverser 	travers
traversées 	travers
travolta 	travolta 
être 	être 
treize 	treiz
treizième 	treiz
trek 	trek 
tremblement 	tremble
trembler 	tremble
tremonti 	tremonti 
trentaine 	trent
trente 	trent
trentième 	trent
tribales 	tribales 
tribunal 	tribun
tribunaux 	tribun
tribune 	tribun
triomphalement 	triomph
triomphe 	triomph
triple 	triple 
tripoli 	tripoli 
tristesse 	tristesse 
trône 	trône 
trois 	trois
troisième 	trois
troisièmes 	trois
trois reprises 	trois
étroits 	étroits 
troïka 	troïka 
trombes 	trom
trompé 	trom
trop 	trop
tropicale 	trop
troublée 	trou
troubler 	trou
troubles 	trou
troupes 	trou
trouvé 	trou
trouvaient 	trou
trouvait 	trou
trouvant 	trou
trouvée 	trou
trouve 	trou
trouve 	trou
trouvent 	trou
trouver 	trou
très 	très 
trump 	trump 
trêve 	trêve 
tsahal 	tsahal 
tsi 	tsi 
tsunami 	tsunami 
tôt 	tôt 
tête 	tête
têtes 	tête
tué 	tué 
tua 	tua 
tuant 	tuant 
tucker 	tucker 
étude 	étud
étudié 	étud
étudiante 	étud
étudient 	étud
étudier 	étud
tuée 	tuée 
tuée 	tuée 
tue 	tue 
tuer 	tuer
tuerie 	tuer
tuées 	tuées 
tueur 	tueur 
tulkarem 	tulkarem 
tuninter 	tuninter 
tunis 	tunis 
tunisair 	tunisair 
tunisie 	tunisie
tunisien 	tunisie
tunisiennes 	tunisie
tunnel 	tunnel 
turc 	turc 
turcs 	turcs 
turin 	turin 
turque 	turqu
turques 	turqu
turquie 	turqu
tués 	tués 
tusk 	tusk 
tutsis 	tutsis 
tv 	tv 
tv5 	tv5 
twin 	twin 
type 	type 
typhon 	typhon 
tyrol 	tyrol 
u2 	u2 
udc 	udc 
ue 	ue 
ue3 	ue3 
ukraine 	ukrain
ukrainien 	ukrainien
ukrainienne 	ukrainien
ulster 	ulster 
ultimatum 	ultim
ultime 	ultim
ultra 	ultra
ultraconservateur 	ultra
ultranationalistes 	ultra
ultérieur 	ultérieur 
ump 	ump 
unanime 	unanim
unanimité 	unanim
une bombe 	une bombe 
une brève 	une brève 
une magnitude 	une magnitude 
unesco 	unesco 
uni 	uni 
unicef 	unicef 
unie 	unie 
unies 	unies 
unifiée 	unifiée 
unilatéralement 	unilatéralement 
uninominal 	uninominal 
union 	union
unions 	union
unique 	unique
uniquement 	unique
unir 	unir 
unis 	unis 
unissent 	unissent 
unité 	unité 
universel 	universel
universelle 	universel
université 	universit
universitaire 	universit
universités 	universit
uns 	uns 
uranium 	uranium 
urbain 	urbain
urbaines 	urbain
urbi 	urbi 
urgence 	urgen
urgent 	urgen
urgente 	urgen
urinaires 	urinaires 
urnes 	urnes 
urss 	urss 
us 	us 
usa 	usa 
usine 	usine 
uss 	uss 
utilisé 	utilis
utilisation 	utilis
utilisée 	utilis
utilisées 	utilis
utilisés 	utilis
utopie 	utopie 
va 	va 
vacances 	vacances 
vaches 	vaches 
évacué 	évacu
évacuation 	évacu
évacuations 	évacu
évacuée 	évacu
évacuent 	évacu
évacuer 	évacu
évacuées 	évacu
évacués 	évacu
vague 	vague 
vain 	vain
vaincre 	vain
vaincu 	vain
vaincus 	vain
vainqueur 	vain
vainqueurs 	vain
val 	val 
valables 	valables 
valence 	vale
valeur 	vale
validé 	valid
validation 	valid
validité 	valid
vallée 	vall
valls 	vall
valoir 	valoir 
valéry 	valéry 
valse 	valse 
évaluée 	évalu
évaluer 	évalu
van 	van 
vandalisme 	vandalisme 
vanity 	vanity 
vannes 	vannes 
évanoui 	évanoui 
varsovie 	varsovie 
vasculaire 	vasculaire 
évasion 	évasion 
vaste 	vaste 
vatican 	vatican
vaticane 	vatican
vaticanes 	vatican
vautours 	vautours 
vécu 	vécu
vécut 	vécu
vecteurs 	vecteurs 
vedette 	vedette 
veillé 	veill
veillée 	veill
veille 	veill
veille 	veill
velours 	velours 
venaient 	venai
venait 	venai
vend 	vend 
vendeurs 	vendeurs 
vendredi 	vendredi 
vendus 	vendus 
venezuela 	venezuela 
vengeance 	venge
venger 	venge
venir 	venir 
vent 	vent 
vente 	vente 
ventes 	ventes 
vents 	vents 
éventuel 	éventuel
éventuelle 	éventuel
éventuelles 	éventuel
éventuels 	éventuel
venu 	venu 
venue 	venue 
venus 	venus 
verbale 	verbale
verbales 	verbale
verdict 	verdi
verdier 	verdi
verra 	verra 
verront 	verront 
verrous 	verrous 
vers 	vers 
versé 	versé 
versée 	versée 
versements 	versements 
verser 	verser 
versets 	versets 
version 	version
versions 	version
vert 	vert 
vertement 	vertement 
vertige 	vertige 
vertu 	vertu 
vertus 	vertus 
veulent 	veulent 
veut 	veut 
végétatif 	végétatif 
véhicule 	véhicule
véhicules 	véhicule
véhémence 	véhémence 
via 	via 
vice 	vice 
victime 	victime
victimes 	victime
éviction 	éviction 
victoire 	victo
victorieuse 	victo
évidemment 	évidemment 
vides 	vides 
videur 	videur 
vidéo 	vidéo
vidéoconférence 	vidéo
vidéos 	vidéo
vie 	vie 
vieil 	vieil 
viendra 	viendra 
vienne 	vienne
viennent 	vienne
vient 	vient 
vierge 	vierge 
vies 	vies 
vietnam 	vietnam 
vieux 	vieux 
vif 	vif 
vifs 	vifs 
vigilance 	vigilance 
vigoureux 	vigoureux 
vigueur 	vigueur 
vii 	vii 
viktor 	viktor 
village 	village
villageois 	village
villages 	village
villaraigosa 	vill
ville 	vill
villepin 	vill
villes 	vill
vin 	vin 
vincent 	vincent 
vinci 	vinci 
vindicatif 	vindicatif 
vingt 	vingt
vingtaine 	vingt
viol 	viol
viol 	viol
violé 	viol
violé 	viol
violation 	viol
violemment 	viol
violence 	viol
violences 	viol
violent 	viol
violente 	viol
violentes 	viol
violents 	viol
violer 	viol
violerait 	viol
viols 	viol
virage 	virage 
vire 	vire 
virginie 	virginie 
virtuose 	virtuose 
virulent 	virulent
virulentes 	virulent
virus 	virus 
vis 	vis 
visé 	visé 
visé 	visé 
visa 	visa 
visage 	visage 
visaient 	visaient 
visait 	visait 
visant 	visant 
visas 	visas 
vise 	vise 
viserait 	viserait 
visées 	visées 
visible 	visible
visiblement 	visible
visions 	visions 
visité 	visité 
visite 	visite 
visitent 	visitent 
visiter 	visiter 
visites 	visites 
visés 	visés 
visu 	visu 
évité 	évité 
vit 	vit 
vit 	vit 
vital 	vital
vitales 	vital
évitant 	évitant 
vitaux 	vitaux 
évite 	évite
vite 	vite 
évitent 	évite
éviter 	évite
vitesse 	vitesse 
vitriol 	vitriol 
évités 	évités 
vivait 	vivait 
vivant 	vivant
vivantes 	vivant
vivants 	vivant
vive 	vive 
vivement 	vivement 
vivent 	vivent 
vives 	vives 
vivre 	vivre
vivres 	vivre
vladimir 	vladimir 
vélo 	vélo 
vénalité 	vénalité 
événement 	événement
événements 	événement
vénérée 	véné
vénézuélien 	vénézuélien
vénézuéliennes 	vénézuélien
vocation 	vocation
vocations 	vocation
voeux 	voeux 
voici 	voici 
voie 	voie 
voient 	voient 
voies 	voies 
voir 	voir 
voisins 	voisins 
voit 	voit 
voiture 	voiture
voitures 	voiture
voix 	voix 
vol 	vol 
volatilisé 	volatilisé 
voler 	voler 
volet 	volet 
volets 	volets 
volonté 	volont
volontairement 	volontaire
volontaires 	volontaire
volontarisme 	volont
vols 	vols 
évolue 	évolu
évolution 	évolution
évolutions 	évolution
vont 	vont 
évoqué 	évoqu
évoquaient 	évoqu
évoquait 	évoqu
évoquant 	évoqu
évoque 	évoqu
évoquent 	évoqu
évoquer 	évoqu
évoquées 	évoqu
évoqués 	évoqu
vos 	vos 
voté 	voté 
votants 	votants 
votée 	votée 
vote 	vote 
votent 	votent 
voter 	voter 
voteront 	voteront 
votes 	votes 
voulaient 	voulai
voulait 	voulai
vouloir 	vouloir 
voulu 	voulu 
vous 	vous 
voyage 	voyage
voyageur 	voyageur
voyageurs 	voyageur
voyous 	voyous 
évêque 	évêque
évêques 	évêque
vrai 	vrai
vrais 	vrai
vraisemblablement 	vrai
vérifiée 	vérifi
vérifier 	vérifi
vérité 	véri
véritable 	véritable
véritablement 	véritable
vrp 	vrp 
vs 	vs 
vêtements 	vêtements 
vu 	vu 
vue 	vue 
vues 	vues 
vulnérable 	vulnérable 
w 	w 
wadowice 	wadowice 
wagons 	wagons 
walesa 	walesa 
walid 	walid 
walter 	walter 
war 	war 
warrior 	warrior 
washington 	washington 
watch 	watch 
watergate 	watergate 
weah 	weah 
week 	week 
weise 	weise 
west 	west
westphalie 	west
wiesenthal 	wiesenthal 
williams 	williams 
wilma 	wilma 
windsor 	windsor 
winner 	winner 
wisconsin 	wisconsin 
wojtyla 	wojtyla 
wonderwoman 	wonderwoman 
word 	word 
world 	world 
x 	x 
xvi 	xvi 
xxe 	xxe 
xxiii 	xxiii 
xxème 	xxème 
y 	y 
yacine 	yacine 
yam 	yam 
yama 	yama 
yamaguchi 	yamaguchi 
yamoussoukro 	yamoussoukro 
yard 	yard 
yasser 	yasser 
yeni 	yeni 
yes 	yes 
yeux 	yeux 
yémen 	yémen 
york 	york
yorkais 	york
yorkshire 	york
yougoslavie 	yougoslavie 
young 	young 
younès 	younès 
yucatan 	yucatan 
yves 	yves 
zacarias 	zacarias 
zambie 	zambie
zambienne 	zambie
zamboanga 	zamb
zapatero 	zapatero 
zaïre 	zaïre 
zarkaoui 	zarkaoui 
zarqaoui 	zarqaoui 
zawahari 	zawah
zawahiri 	zawah
zone 	zone
zones 	zone
zoophile 	zoophil
zoophilie 	zoophil
